Commodity,Month,Year,Quarter,Time,Balance ($US),Total Exports Value ($US),Customs Import Value (Gen) ($US)
All Commodities,January,2002,Q1,January 2002,-6846054338,1569313503,8415367841
All Commodities,February,2002,Q1,February 2002,-6491284627,1529492578,8020777205
All Commodities,March,2002,Q1,March 2002,-5638471747,1620488889,7258960636
All Commodities,April,2002,Q2,April 2002,-7553013934,1544544989,9097558923
All Commodities,May,2002,Q2,May 2002,-8073020819,1773915631,9846936450
All Commodities,June,2002,Q2,June 2002,-8521227849,2205939528,10727167377
All Commodities,July,2002,Q3,July 2002,-9365219748,1847999145,11213218893
All Commodities,August,2002,Q3,August 2002,-10831610144,1839815968,12671426112
All Commodities,September,2002,Q3,September 2002,-10267792906,2023728253,12291521159
All Commodities,October,2002,Q4,October 2002,-9492259430,1962695203,11454954633
All Commodities,November,2002,Q4,November 2002,-10408826648,2160758163,12569584811
All Commodities,December,2002,Q4,December 2002,-9575892568,2049098442,11624991010
All Commodities,January,2003,Q1,January 2003,-9333665682,2069831893,11403497575
All Commodities,February,2003,Q1,February 2003,-7580956295,2048670815,9629627110
All Commodities,March,2003,Q1,March 2003,-7686939854,2423104708,10110044562
All Commodities,April,2003,Q2,April 2003,-9399905702,2121946680,11521852382
All Commodities,May,2003,Q2,May 2003,-9900382810,1984318683,11884701493
All Commodities,June,2003,Q2,June 2003,-10007680292,2119621137,12127301429
All Commodities,July,2003,Q3,July 2003,-11371229512,2067405578,13438635090
All Commodities,August,2003,Q3,August 2003,-11730438781,2034428227,13764867008
All Commodities,September,2003,Q3,September 2003,-12656548622,2090976796,14747525418
All Commodities,October,2003,Q4,October 2003,-13679981152,2778336455,16458317607
All Commodities,November,2003,Q4,November 2003,-10837255312,3319692649,14156947961
All Commodities,December,2003,Q4,December 2003,-9883170025,3309609238,13192779263
All Commodities,January,2004,Q1,January 2004,-11468525703,2620489793,14089015496
All Commodities,February,2004,Q1,February 2004,-8338156059,2928991616,11267147675
All Commodities,March,2004,Q1,March 2004,-10438209270,3361910701,13800119971
All Commodities,April,2004,Q2,April 2004,-12010230290,2734553860,14744784150
All Commodities,May,2004,Q2,May 2004,-12232058855,2835052068,15067110923
All Commodities,June,2004,Q2,June 2004,-14123545467,2764217124,16887762591
All Commodities,July,2004,Q3,July 2004,-14943305964,2618793915,17562099879
All Commodities,August,2004,Q3,August 2004,-15446896244,2620970808,18067867052
All Commodities,September,2004,Q3,September 2004,-15563875193,2823070552,18386945745
All Commodities,October,2004,Q4,October 2004,-16771413659,2946743822,19718157481
All Commodities,November,2004,Q4,November 2004,-16740816772,2938175371,19678992143
All Commodities,December,2004,Q4,December 2004,-14177228003,3234802826,17412030829
All Commodities,January,2005,Q1,January 2005,-15276514484,2609326126,17885840610
All Commodities,February,2005,Q1,February 2005,-13879505721,3058089091,16937594812
All Commodities,March,2005,Q1,March 2005,-12848563774,3336381178,16184944952
All Commodities,April,2005,Q2,April 2005,-14884787406,3263670754,18148458160
All Commodities,May,2005,Q2,May 2005,-15830277142,3222909738,19053186880
All Commodities,June,2005,Q2,June 2005,-17605971051,3370730806,20976701857
All Commodities,July,2005,Q3,July 2005,-17712697315,3559972145,21272669460
All Commodities,August,2005,Q3,August 2005,-18692568501,3728723847,22421292348
All Commodities,September,2005,Q3,September 2005,-20128668413,3165813266,23294481679
All Commodities,October,2005,Q4,October 2005,-20483701230,3899151496,24382852726
All Commodities,November,2005,Q4,November 2005,-18618636744,3807491572,22426128316
All Commodities,December,2005,Q4,December 2005,-16316202891,4169750104,20485952995
All Commodities,January,2006,Q1,January 2006,-17985635758,3396870149,21382505907
All Commodities,February,2006,Q1,February 2006,-13833108381,4072245086,17905353467
All Commodities,March,2006,Q1,March 2006,-15664193620,4867064710,20531258330
All Commodities,April,2006,Q2,April 2006,-17226665438,4232404495,21459069933
All Commodities,May,2006,Q2,May 2006,-17883545082,4434090049,22317635131
All Commodities,June,2006,Q2,June 2006,-19686794060,4302905336,23989699396
All Commodities,July,2006,Q3,July 2006,-19825735662,4806275103,24632010765
All Commodities,August,2006,Q3,August 2006,-22110066658,4603268577,26713335235
All Commodities,September,2006,Q3,September 2006,-23109608039,4461009876,27570617915
All Commodities,October,2006,Q4,October 2006,-24503337564,4885264175,29388601739
All Commodities,November,2006,Q4,November 2006,-23179256599,4595822622,27775079221
All Commodities,December,2006,Q4,December 2006,-19093397408,5015788165,24109185573
All Commodities,January,2007,Q1,January 2007,-21251028051,4389534621,25640562672
All Commodities,February,2007,Q1,February 2007,-18505990388,4532889974,23038880362
All Commodities,March,2007,Q1,March 2007,-17297650347,5425393888,22723044235
All Commodities,April,2007,Q2,April 2007,-19537571558,4703951215,24241522773
All Commodities,May,2007,Q2,May 2007,-20161137702,5129436740,25290574442
All Commodities,June,2007,Q2,June 2007,-21509187948,5561773250,27070961198
All Commodities,July,2007,Q3,July 2007,-23935233558,4665937256,28601170814
All Commodities,August,2007,Q3,August 2007,-22871703868,5552797567,28424501435
All Commodities,September,2007,Q3,September 2007,-24107091621,5311870909,29418962530
All Commodities,October,2007,Q4,October 2007,-26022486420,5532919982,31555406402
All Commodities,November,2007,Q4,November 2007,-24199213792,5581504999,29780718791
All Commodities,December,2007,Q4,December 2007,-19107680105,6548881175,25656561280
All Commodities,January,2008,Q1,January 2008,-20636323293,5556708852,26193032145
All Commodities,February,2008,Q1,February 2008,-18397831678,5698054777,24095886455
All Commodities,March,2008,Q1,March 2008,-16145890062,6294351708,22440241770
All Commodities,April,2008,Q2,April 2008,-20300418636,5651248360,25951666996
All Commodities,May,2008,Q2,May 2008,-21358860127,6275672316,27634532443
All Commodities,June,2008,Q2,June 2008,-21742474197,6188166337,27930640534
All Commodities,July,2008,Q3,July 2008,-25012634967,6234635702,31247270669
All Commodities,August,2008,Q3,August 2008,-25622401511,6201296378,31823697889
All Commodities,September,2008,Q3,September 2008,-27821083988,5257646643,33078730631
All Commodities,October,2008,Q4,October 2008,-27948988148,6083400135,34032388283
All Commodities,November,2008,Q4,November 2008,-23084074890,5180950140,28265025030
All Commodities,December,2008,Q4,December 2008,-19968808783,5110706195,25079514978
All Commodities,January,2009,Q1,January 2009,-20583807646,4159649756,24743457402
All Commodities,February,2009,Q1,February 2009,-14183813848,4661681362,18845495210
All Commodities,March,2009,Q1,March 2009,-15645454490,5579259023,21224713513
All Commodities,April,2009,Q2,April 2009,-16759152639,5161442609,21920595248
All Commodities,May,2009,Q2,May 2009,-17478129748,5256018098,22734147846
All Commodities,June,2009,Q2,June 2009,-18424199656,5548574581,23972774237
All Commodities,July,2009,Q3,July 2009,-20401797708,5269286701,25671084409
All Commodities,August,2009,Q3,August 2009,-20280145429,5517974227,25798119656
All Commodities,September,2009,Q3,September 2009,-22129567804,5764348788,27893916592
All Commodities,October,2009,Q4,October 2009,-22678482832,6879300033,29557782865
All Commodities,November,2009,Q4,November 2009,-20167560139,7374160636,27541720775
All Commodities,December,2009,Q4,December 2009,-18145092938,8324982797,26470075735
All Commodities,January,2010,Q1,January 2010,-18317560150,6898358856,25215919006
All Commodities,February,2010,Q1,February 2010,-16502550033,6840227481,23342777514
All Commodities,March,2010,Q1,March 2010,-16891438582,7400774615,24292213197
All Commodities,April,2010,Q2,April 2010,-19319462715,6600725426,25920188141
All Commodities,May,2010,Q2,May 2010,-22297152550,6755285795,29052438345
All Commodities,June,2010,Q2,June 2010,-26109381487,6733718548,32843100035
All Commodities,July,2010,Q3,July 2010,-25927577562,7339256032,33266833594
All Commodities,August,2010,Q3,August 2010,-28165553582,7209734849,35375288431
All Commodities,September,2010,Q3,September 2010,-28082387628,7114311226,35196698854
All Commodities,October,2010,Q4,October 2010,-25666010910,9417288527,35083299437
All Commodities,November,2010,Q4,November 2010,-25088448927,9475844966,34564293893
All Commodities,December,2010,Q4,December 2010,-20674028525,10125554623,30799583148
All Commodities,January,2011,Q1,January 2011,-23359561912,8017791834,31377353746
All Commodities,February,2011,Q1,February 2011,-18861425689,8383310124,27244735813
All Commodities,March,2011,Q1,March 2011,-18035938576,9563728281,27599666857
All Commodities,April,2011,Q2,April 2011,-21579779390,8000503316,29580282706
All Commodities,May,2011,Q2,May 2011,-24938912298,7849159315,32788071613
All Commodities,June,2011,Q2,June 2011,-26507825705,7867005088,34374830793
All Commodities,July,2011,Q3,July 2011,-26994342067,8157901187,35152243254
All Commodities,August,2011,Q3,August 2011,-28952494457,8421642066,37374136523
All Commodities,September,2011,Q3,September 2011,-28048579304,8370063556,36418642860
All Commodities,October,2011,Q4,October 2011,-28078515559,9745556144,37824071703
All Commodities,November,2011,Q4,November 2011,-26767716047,9997195589,36764911636
All Commodities,December,2011,Q4,December 2011,-23124617992,9747667135,32872285127
All Commodities,January,2012,Q1,January 2012,-26058067707,8359472713,34417540420
All Commodities,February,2012,Q1,February 2012,-19319523641,8785662778,28105186419
All Commodities,March,2012,Q1,March 2012,-21619772405,9811576526,31431348931
All Commodities,April,2012,Q2,April 2012,-24548111852,8468141982,33016253834
All Commodities,May,2012,Q2,May 2012,-25977674946,8960154977,34937829923
All Commodities,June,2012,Q2,June 2012,-27471242143,8478117308,35949359451
All Commodities,July,2012,Q3,July 2012,-29415659705,8515095501,37930755206
All Commodities,August,2012,Q3,August 2012,-28667293825,8613335319,37280629144
All Commodities,September,2012,Q3,September 2012,-29087613369,8804209690,37891823059
All Commodities,October,2012,Q4,October 2012,-29432652128,10824431396,40257083524
All Commodities,November,2012,Q4,November 2012,-28955907635,10587785547,39543693182
All Commodities,December,2012,Q4,December 2012,-24548947609,10308631935,34857579544
All Commodities,January,2013,Q1,January 2013,-27810735657,9382923146,37193658803
All Commodities,February,2013,Q1,February 2013,-23609359985,9133317600,32742677585
All Commodities,March,2013,Q1,March 2013,-17755035864,9539031339,27294067203
All Commodities,April,2013,Q2,April 2013,-24177971774,8953954532,33131926306
All Commodities,May,2013,Q2,May 2013,-27864795955,8752827685,36617623640
All Commodities,June,2013,Q2,June 2013,-26668352502,9217626330,35885978832
All Commodities,July,2013,Q3,July 2013,-30076722478,8723708150,38800430628
All Commodities,August,2013,Q3,August 2013,-29809180019,9352119496,39161299515
All Commodities,September,2013,Q3,September 2013,-30617215865,9527176643,40144392508
All Commodities,October,2013,Q4,October 2013,-28697708309,13147763822,41845472131
All Commodities,November,2013,Q4,November 2013,-27085196972,13027082593,40112279565
All Commodities,December,2013,Q4,December 2013,-24511555575,12988657301,37500212876
All Commodities,January,2014,Q1,January 2014,-28112657018,10264542542,38377199560
All Commodities,February,2014,Q1,February 2014,-20949656145,9750696184,30700352329
All Commodities,March,2014,Q1,March 2014,-20486599175,10934276106,31420875281
All Commodities,April,2014,Q2,April 2014,-27418317983,9031900812,36450218795
All Commodities,May,2014,Q2,May 2014,-28967973788,9220161982,38188135770
All Commodities,June,2014,Q2,June 2014,-30276899087,9330219574,39607118661
All Commodities,July,2014,Q3,July 2014,-31027827282,9291791064,40319618346
All Commodities,August,2014,Q3,August 2014,-30468644322,9625172763,40093817085
All Commodities,September,2014,Q3,September 2014,-35788807711,9313967699,45102775410
All Commodities,October,2014,Q4,October 2014,-32742017424,12593334298,45335351722
All Commodities,November,2014,Q4,November 2014,-30357598919,12125930519,42483529438
All Commodities,December,2014,Q4,December 2014,-28220692596,12175209863,40395902459
All Commodities,January,2015,Q1,January 2015,-29130498337,9459198394,38589696731
All Commodities,February,2015,Q1,February 2015,-22809399977,8754588178,31563988155
All Commodities,March,2015,Q1,March 2015,-31250398366,9886519164,41136917530
All Commodities,April,2015,Q2,April 2015,-26841481617,9279912850,36121394467
All Commodities,May,2015,Q2,May 2015,-30332242342,8749787563,39082029905
All Commodities,June,2015,Q2,June 2015,-31838085680,9615754115,41453839795
All Commodities,July,2015,Q3,July 2015,-31709904617,9505173559,41215078176
All Commodities,August,2015,Q3,August 2015,-34954599191,9183456081,44138055272
All Commodities,September,2015,Q3,September 2015,-36305530076,9419421166,45724951242
All Commodities,October,2015,Q4,October 2015,-32985076272,11324856248,44309932520
All Commodities,November,2015,Q4,November 2015,-31281181471,10603592681,41884774152
All Commodities,December,2015,Q4,December 2015,-27889892104,10091105315,37980997419
All Commodities,January,2016,Q1,January 2016,-28917547743,8208886377,37126434120
All Commodities,February,2016,Q1,February 2016,-27986377462,8080515063,36066892525
All Commodities,March,2016,Q1,March 2016,-20886765697,8925561211,29812326908
All Commodities,April,2016,Q2,April 2016,-24240536063,8679668476,32920204539
All Commodities,May,2016,Q2,May 2016,-28971763554,8541963035,37513726589
All Commodities,June,2016,Q2,June 2016,-29693632418,8845557796,38539190214
All Commodities,July,2016,Q3,July 2016,-30309191457,9129666281,39438857738
All Commodities,August,2016,Q3,August 2016,-33848854947,9372919258,43221774205
All Commodities,September,2016,Q3,September 2016,-32499776611,9521151936,42020928547
All Commodities,October,2016,Q4,October 2016,-31198093714,12600004710,43798098424
All Commodities,November,2016,Q4,November 2016,-30558546910,12044084823,42602631733
All Commodities,December,2016,Q4,December 2016,-27714120550,11644805511,39358926061
All Commodities,January,2017,Q1,January 2017,-31380030594,9955522802,41335553396
All Commodities,February,2017,Q1,February 2017,-23045142497,9739814915,32784957412
All Commodities,March,2017,Q1,March 2017,-24441809552,9720184109,34161993661
All Commodities,April,2017,Q2,April 2017,-27635394053,9806476826,37441870879
All Commodities,May,2017,Q2,May 2017,-31876821200,9880023522,41756844722
All Commodities,June,2017,Q2,June 2017,-32539867690,9718210931,42258078621
All Commodities,July,2017,Q3,July 2017,-33607047544,9954063313,43561110857
All Commodities,August,2017,Q3,August 2017,-34956851179,10825460770,45782311949
All Commodities,September,2017,Q3,September 2017,-34509071971,10895979304,45405051275
All Commodities,October,2017,Q4,October 2017,-35169927442,12963222187,48133149629
All Commodities,November,2017,Q4,November 2017,-35196399188,12908394227,48104793415
All Commodities,December,2017,Q4,December 2017,-30809507904,13629874337,44439382241
All Commodities,January,2018,Q1,January 2018,-35839714626,9910227741,45749942367
All Commodities,February,2018,Q1,February 2018,-29261850514,9741752846,39003603360
All Commodities,March,2018,Q1,March 2018,-25641930970,12653174318,38295105288
All Commodities,April,2018,Q2,April 2018,-27758897551,10510478379,38269375930
All Commodities,May,2018,Q2,May 2018,-33542028511,10396624247,43938652758
All Commodities,June,2018,Q2,June 2018,-33712940317,10858294665,44571234982
All Commodities,July,2018,Q3,July 2018,-36931059713,10156527887,47087587600
All Commodities,August,2018,Q3,August 2018,-38536558974,9280892425,47817451399
All Commodities,September,2018,Q3,September 2018,-40255664416,9732404733,49988069149
All Commodities,October,2018,Q4,October 2018,-42982552446,9187533643,52170086089
All Commodities,November,2018,Q4,November 2018,-37794803057,8650888998,46445692055
All Commodities,December,2018,Q4,December 2018,-36695850459,9210487995,45906338454
All Commodities,January,2019,Q1,January 2019,-34409324145,7105125159,41514449304
All Commodities,February,2019,Q1,February 2019,-25071607653,8083304442,33154912095
All Commodities,March,2019,Q1,March 2019,-20600639365,10574937623,31175576988
All Commodities,April,2019,Q2,April 2019,-26799636307,7883015916,34682652223
All Commodities,May,2019,Q2,May 2019,-30103942061,9069418815,39173360876
All Commodities,June,2019,Q2,June 2019,-29800945499,9166696315,38967641814
All Commodities,July,2019,Q3,July 2019,-32754912332,8694298164,41449210496
All Commodities,August,2019,Q3,August 2019,-31735496339,9415647335,41151143674
All Commodities,September,2019,Q3,September 2019,-31568190457,8597272439,40165462896
All Commodities,October,2019,Q4,October 2019,-31263667701,8851210888,40114878589
All Commodities,November,2019,Q4,November 2019,-26333272849,10103334138,36436606987
All Commodities,December,2019,Q4,December 2019,-24762552315,8902989856,33665542171
Agricultural Products,January,2002,Q1,January 2002,203427993,216357463,12929470
Agricultural Products,February,2002,Q1,February 2002,144113567,155206914,11093347
Agricultural Products,March,2002,Q1,March 2002,4188454,14860976,10672522
Agricultural Products,April,2002,Q2,April 2002,7819808,18109447,10289639
Agricultural Products,May,2002,Q2,May 2002,9206363,18985230,9778867
Agricultural Products,June,2002,Q2,June 2002,28699993,37769207,9069214
Agricultural Products,July,2002,Q3,July 2002,19020075,33020329,14000254
Agricultural Products,August,2002,Q3,August 2002,11872832,26753210,14880378
Agricultural Products,September,2002,Q3,September 2002,3389857,19507761,16117904
Agricultural Products,October,2002,Q4,October 2002,266464423,276675112,10210689
Agricultural Products,November,2002,Q4,November 2002,257311898,269179711,11867813
Agricultural Products,December,2002,Q4,December 2002,135692975,151339802,15646827
Agricultural Products,January,2003,Q1,January 2003,394131323,410166419,16035096
Agricultural Products,February,2003,Q1,February 2003,441502398,456770794,15268396
Agricultural Products,March,2003,Q1,March 2003,306997813,318514079,11516266
Agricultural Products,April,2003,Q2,April 2003,189567376,202073566,12506190
Agricultural Products,May,2003,Q2,May 2003,51086873,65087942,14001069
Agricultural Products,June,2003,Q2,June 2003,18735678,31429248,12693570
Agricultural Products,July,2003,Q3,July 2003,59937491,70437023,10499532
Agricultural Products,August,2003,Q3,August 2003,17169369,26796417,9627048
Agricultural Products,September,2003,Q3,September 2003,46045583,59977544,13931961
Agricultural Products,October,2003,Q4,October 2003,463249573,478935216,15685643
Agricultural Products,November,2003,Q4,November 2003,868156205,885680522,17524317
Agricultural Products,December,2003,Q4,December 2003,737393547,756981967,19588420
Agricultural Products,January,2004,Q1,January 2004,507437548,523905137,16467589
Agricultural Products,February,2004,Q1,February 2004,509094482,524099601,15005119
Agricultural Products,March,2004,Q1,March 2004,485856476,500071000,14214524
Agricultural Products,April,2004,Q2,April 2004,255231735,272554129,17322394
Agricultural Products,May,2004,Q2,May 2004,238803227,256019601,17216374
Agricultural Products,June,2004,Q2,June 2004,132977809,151927357,18949548
Agricultural Products,July,2004,Q3,July 2004,80465029,99647283,19182254
Agricultural Products,August,2004,Q3,August 2004,69029035,86806124,17777089
Agricultural Products,September,2004,Q3,September 2004,287475551,304844716,17369165
Agricultural Products,October,2004,Q4,October 2004,568561398,586871357,18309959
Agricultural Products,November,2004,Q4,November 2004,517708928,540364611,22655683
Agricultural Products,December,2004,Q4,December 2004,489677589,516483863,26806274
Agricultural Products,January,2005,Q1,January 2005,308646336,332797469,24151133
Agricultural Products,February,2005,Q1,February 2005,441993372,462278534,20285162
Agricultural Products,March,2005,Q1,March 2005,355494509,376668734,21174225
Agricultural Products,April,2005,Q2,April 2005,184899854,202344109,17444255
Agricultural Products,May,2005,Q2,May 2005,151185095,170520530,19335435
Agricultural Products,June,2005,Q2,June 2005,165477416,187578277,22100861
Agricultural Products,July,2005,Q3,July 2005,325206743,345270328,20063585
Agricultural Products,August,2005,Q3,August 2005,156168143,179054119,22885976
Agricultural Products,September,2005,Q3,September 2005,99912918,123737129,23824211
Agricultural Products,October,2005,Q4,October 2005,535514928,557572881,22057953
Agricultural Products,November,2005,Q4,November 2005,534645029,557200730,22555701
Agricultural Products,December,2005,Q4,December 2005,377648108,401918333,24270225
Agricultural Products,January,2006,Q1,January 2006,452245733,475611539,23365806
Agricultural Products,February,2006,Q1,February 2006,697763213,718251211,20487998
Agricultural Products,March,2006,Q1,March 2006,759120299,778778565,19658266
Agricultural Products,April,2006,Q2,April 2006,341050477,364188059,23137582
Agricultural Products,May,2006,Q2,May 2006,271692207,294911335,23219128
Agricultural Products,June,2006,Q2,June 2006,201672950,226907556,25234606
Agricultural Products,July,2006,Q3,July 2006,296601449,320111765,23510316
Agricultural Products,August,2006,Q3,August 2006,53518802,83693746,30174944
Agricultural Products,September,2006,Q3,September 2006,118691837,143797473,25105636
Agricultural Products,October,2006,Q4,October 2006,603944631,630681622,26736991
Agricultural Products,November,2006,Q4,November 2006,358031568,387670693,29639125
Agricultural Products,December,2006,Q4,December 2006,397490161,430019450,32529289
Agricultural Products,January,2007,Q1,January 2007,454531581,486569699,32038118
Agricultural Products,February,2007,Q1,February 2007,577791746,604720090,26928344
Agricultural Products,March,2007,Q1,March 2007,378028477,405426958,27398481
Agricultural Products,April,2007,Q2,April 2007,289018137,316070199,27052062
Agricultural Products,May,2007,Q2,May 2007,271109596,298949600,27840004
Agricultural Products,June,2007,Q2,June 2007,220745507,249035868,28290361
Agricultural Products,July,2007,Q3,July 2007,202363906,232336802,29972896
Agricultural Products,August,2007,Q3,August 2007,322423423,356378293,33954870
Agricultural Products,September,2007,Q3,September 2007,288952545,319117108,30164563
Agricultural Products,October,2007,Q4,October 2007,614219085,640426281,26207196
Agricultural Products,November,2007,Q4,November 2007,747799983,780220754,32420771
Agricultural Products,December,2007,Q4,December 2007,1076978946,1116389130,39410184
Agricultural Products,January,2008,Q1,January 2008,955751479,996881562,41130083
Agricultural Products,February,2008,Q1,February 2008,940313754,975379335,35065581
Agricultural Products,March,2008,Q1,March 2008,942754327,968552588,25798261
Agricultural Products,April,2008,Q2,April 2008,469780325,507272343,37492018
Agricultural Products,May,2008,Q2,May 2008,416198513,453515427,37316914
Agricultural Products,June,2008,Q2,June 2008,524509907,557878087,33368180
Agricultural Products,July,2008,Q3,July 2008,559396840,592307665,32910825
Agricultural Products,August,2008,Q3,August 2008,233512410,264216639,30704229
Agricultural Products,September,2008,Q3,September 2008,225449498,252274902,26825404
Agricultural Products,October,2008,Q4,October 2008,1129131081,1159913655,30782574
Agricultural Products,November,2008,Q4,November 2008,1206333347,1234068172,27734825
Agricultural Products,December,2008,Q4,December 2008,1185405334,1223480048,38074714
Agricultural Products,January,2009,Q1,January 2009,922992277,954943841,31951564
Agricultural Products,February,2009,Q1,February 2009,1259573912,1279163885,19589973
Agricultural Products,March,2009,Q1,March 2009,624979882,649523486,24543604
Agricultural Products,April,2009,Q2,April 2009,515594212,551546122,35951910
Agricultural Products,May,2009,Q2,May 2009,259632433,288455216,28822783
Agricultural Products,June,2009,Q2,June 2009,324376626,358777814,34401188
Agricultural Products,July,2009,Q3,July 2009,264826692,293582953,28756261
Agricultural Products,August,2009,Q3,August 2009,295832490,324333986,28501496
Agricultural Products,September,2009,Q3,September 2009,327967434,357362658,29395224
Agricultural Products,October,2009,Q4,October 2009,1445154052,1481171146,36017094
Agricultural Products,November,2009,Q4,November 2009,2139454627,2175667696,36213069
Agricultural Products,December,2009,Q4,December 2009,1810734503,1861289418,50554915
Agricultural Products,January,2010,Q1,January 2010,1603855159,1645145693,41290534
Agricultural Products,February,2010,Q1,February 2010,1149486737,1184814297,35327560
Agricultural Products,March,2010,Q1,March 2010,875010699,912238886,37228187
Agricultural Products,April,2010,Q2,April 2010,441647908,478417167,36769259
Agricultural Products,May,2010,Q2,May 2010,191028360,231365927,40337567
Agricultural Products,June,2010,Q2,June 2010,183530218,227198347,43668129
Agricultural Products,July,2010,Q3,July 2010,439327956,473065985,33738029
Agricultural Products,August,2010,Q3,August 2010,503549310,539331733,35782423
Agricultural Products,September,2010,Q3,September 2010,509865050,544502018,34636968
Agricultural Products,October,2010,Q4,October 2010,2565422681,2602107199,36684518
Agricultural Products,November,2010,Q4,November 2010,2777765491,2818188768,40423277
Agricultural Products,December,2010,Q4,December 2010,2110893150,2162689313,51796163
Agricultural Products,January,2011,Q1,January 2011,1886093696,1931291013,45197317
Agricultural Products,February,2011,Q1,February 2011,1976644614,2013228413,36583799
Agricultural Products,March,2011,Q1,March 2011,1538726247,1575300308,36574061
Agricultural Products,April,2011,Q2,April 2011,772728219,815396424,42668205
Agricultural Products,May,2011,Q2,May 2011,379731115,422451526,42720411
Agricultural Products,June,2011,Q2,June 2011,224361823,266479310,42117487
Agricultural Products,July,2011,Q3,July 2011,250239921,284544097,34304176
Agricultural Products,August,2011,Q3,August 2011,305709995,338500850,32790855
Agricultural Products,September,2011,Q3,September 2011,497952854,529132627,31179773
Agricultural Products,October,2011,Q4,October 2011,2090914197,2130866143,39951946
Agricultural Products,November,2011,Q4,November 2011,2431618480,2478178151,46559671
Agricultural Products,December,2011,Q4,December 2011,1860783301,1915181454,54398153
Agricultural Products,January,2012,Q1,January 2012,2055896663,2103077071,47180408
Agricultural Products,February,2012,Q1,February 2012,2042247235,2078475587,36228352
Agricultural Products,March,2012,Q1,March 2012,1633149497,1678360510,45211013
Agricultural Products,April,2012,Q2,April 2012,823047693,868773588,45725895
Agricultural Products,May,2012,Q2,May 2012,1024641771,1073021888,48380117
Agricultural Products,June,2012,Q2,June 2012,693675774,753969241,60293467
Agricultural Products,July,2012,Q3,July 2012,814381443,868701490,54320047
Agricultural Products,August,2012,Q3,August 2012,986217888,1032665313,46447425
Agricultural Products,September,2012,Q3,September 2012,1368404110,1417772012,49367902
Agricultural Products,October,2012,Q4,October 2012,3209487717,3263880110,54392393
Agricultural Products,November,2012,Q4,November 2012,3285420041,3359336521,73916480
Agricultural Products,December,2012,Q4,December 2012,2143954561,2217351584,73397023
Agricultural Products,January,2013,Q1,January 2013,2213597633,2287525695,73928062
Agricultural Products,February,2013,Q1,February 2013,2001205655,2046730305,45524650
Agricultural Products,March,2013,Q1,March 2013,1149337642,1195718259,46380617
Agricultural Products,April,2013,Q2,April 2013,396779034,446994416,50215382
Agricultural Products,May,2013,Q2,May 2013,273056662,330947192,57890530
Agricultural Products,June,2013,Q2,June 2013,244809769,301955934,57146165
Agricultural Products,July,2013,Q3,July 2013,292141848,348359075,56217227
Agricultural Products,August,2013,Q3,August 2013,329325732,381419360,52093628
Agricultural Products,September,2013,Q3,September 2013,968995860,1020578465,51582605
Agricultural Products,October,2013,Q4,October 2013,3497215664,3559266520,62050856
Agricultural Products,November,2013,Q4,November 2013,4024921402,4083517764,58596362
Agricultural Products,December,2013,Q4,December 2013,2837249229,2898895350,61646121
Agricultural Products,January,2014,Q1,January 2014,2739693061,2805577136,65884075
Agricultural Products,February,2014,Q1,February 2014,2124412827,2171320088,46907261
Agricultural Products,March,2014,Q1,March 2014,1210439374,1246981262,36541888
Agricultural Products,April,2014,Q2,April 2014,423041985,475780750,52738765
Agricultural Products,May,2014,Q2,May 2014,231751799,287293166,55541367
Agricultural Products,June,2014,Q2,June 2014,126191500,178501744,52310244
Agricultural Products,July,2014,Q3,July 2014,232316812,286285356,53968544
Agricultural Products,August,2014,Q3,August 2014,234091274,276871290,42780016
Agricultural Products,September,2014,Q3,September 2014,684563680,729589903,45026223
Agricultural Products,October,2014,Q4,October 2014,3205067326,3261742871,56675545
Agricultural Products,November,2014,Q4,November 2014,3745972781,3796073861,50101080
Agricultural Products,December,2014,Q4,December 2014,2704627482,2775431435,70803953
Agricultural Products,January,2015,Q1,January 2015,2194785299,2256852481,62067182
Agricultural Products,February,2015,Q1,February 2015,1450901438,1495121469,44220031
Agricultural Products,March,2015,Q1,March 2015,1021266758,1075792834,54526076
Agricultural Products,April,2015,Q2,April 2015,570826466,625910862,55084396
Agricultural Products,May,2015,Q2,May 2015,323097622,376846998,53749376
Agricultural Products,June,2015,Q2,June 2015,175533976,232283242,56749266
Agricultural Products,July,2015,Q3,July 2015,275513467,333886468,58373001
Agricultural Products,August,2015,Q3,August 2015,213663993,268393959,54729966
Agricultural Products,September,2015,Q3,September 2015,689223252,737858375,48635123
Agricultural Products,October,2015,Q4,October 2015,2999239532,3061806058,62566526
Agricultural Products,November,2015,Q4,November 2015,2645543407,2702311495,56768088
Agricultural Products,December,2015,Q4,December 2015,1636784754,1697944371,61159617
Agricultural Products,January,2016,Q1,January 2016,1557727973,1610144805,52416832
Agricultural Products,February,2016,Q1,February 2016,1412110450,1459048828,46938378
Agricultural Products,March,2016,Q1,March 2016,648461880,692737348,44275468
Agricultural Products,April,2016,Q2,April 2016,247485679,300365923,52880244
Agricultural Products,May,2016,Q2,May 2016,171666913,229646678,57979765
Agricultural Products,June,2016,Q2,June 2016,226866358,281896146,55029788
Agricultural Products,July,2016,Q3,July 2016,683384519,728343340,44958821
Agricultural Products,August,2016,Q3,August 2016,989164910,1046244392,57079482
Agricultural Products,September,2016,Q3,September 2016,1132319941,1177180318,44860377
Agricultural Products,October,2016,Q4,October 2016,3565534599,3620830405,55295806
Agricultural Products,November,2016,Q4,November 2016,3365455838,3427046313,61590475
Agricultural Products,December,2016,Q4,December 2016,2602119975,2679220467,77100492
Agricultural Products,January,2017,Q1,January 2017,2044997109,2108877199,63880090
Agricultural Products,February,2017,Q1,February 2017,1324800721,1365732040,40931319
Agricultural Products,March,2017,Q1,March 2017,914515103,956915201,42400098
Agricultural Products,April,2017,Q2,April 2017,525271328,574553241,49281913
Agricultural Products,May,2017,Q2,May 2017,393357597,444972070,51614473
Agricultural Products,June,2017,Q2,June 2017,309175287,360817091,51641804
Agricultural Products,July,2017,Q3,July 2017,517059861,562517014,45457153
Agricultural Products,August,2017,Q3,August 2017,667124964,707576953,40451989
Agricultural Products,September,2017,Q3,September 2017,1238738844,1279661028,40922184
Agricultural Products,October,2017,Q4,October 2017,2770699311,2834625828,63926517
Agricultural Products,November,2017,Q4,November 2017,2674840679,2728299857,53459178
Agricultural Products,December,2017,Q4,December 2017,1799502859,1854926375,55423516
Agricultural Products,January,2018,Q1,January 2018,1522271536,1580714587,58443051
Agricultural Products,February,2018,Q1,February 2018,1166525256,1215324344,48799088
Agricultural Products,March,2018,Q1,March 2018,924139616,973140239,49000623
Agricultural Products,April,2018,Q2,April 2018,503359657,547180592,43820935
Agricultural Products,May,2018,Q2,May 2018,354071903,403634411,49562508
Agricultural Products,June,2018,Q2,June 2018,186088463,236477277,50388814
Agricultural Products,July,2018,Q3,July 2018,143730847,194065472,50334625
Agricultural Products,August,2018,Q3,August 2018,79364677,133228981,53864304
Agricultural Products,September,2018,Q3,September 2018,36671388,84609353,47937965
Agricultural Products,October,2018,Q4,October 2018,130618361,181481265,50862904
Agricultural Products,November,2018,Q4,November 2018,83169073,129730418,46561345
Agricultural Products,December,2018,Q4,December 2018,108967511,172974601,64007090
Agricultural Products,January,2019,Q1,January 2019,509507316,551740953,42233637
Agricultural Products,February,2019,Q1,February 2019,814719024,843531449,28812425
Agricultural Products,March,2019,Q1,March 2019,656486669,691479227,34992558
Agricultural Products,April,2019,Q2,April 2019,360642350,394165741,33523391
Agricultural Products,May,2019,Q2,May 2019,608275664,650364822,42089158
Agricultural Products,June,2019,Q2,June 2019,809524622,852383667,42859045
Agricultural Products,July,2019,Q3,July 2019,792600878,827559454,34958576
Agricultural Products,August,2019,Q3,August 2019,1092914990,1128356569,35441579
Agricultural Products,September,2019,Q3,September 2019,445185496,482731317,37545821
Agricultural Products,October,2019,Q4,October 2019,771261162,812073108,40811946
Agricultural Products,November,2019,Q4,November 2019,1828990125,1867226272,38236147
Agricultural Products,December,2019,Q4,December 2019,1134261173,1180222489,45961316
Livestock & Livestock Products,January,2002,Q1,January 2002,-3333111,263514,3596625
Livestock & Livestock Products,February,2002,Q1,February 2002,-1280600,1228690,2509290
Livestock & Livestock Products,March,2002,Q1,March 2002,1114643,4098215,2983572
Livestock & Livestock Products,April,2002,Q2,April 2002,-866311,1866021,2732332
Livestock & Livestock Products,May,2002,Q2,May 2002,-350849,928216,1279065
Livestock & Livestock Products,June,2002,Q2,June 2002,639821,1936885,1297064
Livestock & Livestock Products,July,2002,Q3,July 2002,519880,2231767,1711887
Livestock & Livestock Products,August,2002,Q3,August 2002,1984257,3146603,1162346
Livestock & Livestock Products,September,2002,Q3,September 2002,-595559,1095882,1691441
Livestock & Livestock Products,October,2002,Q4,October 2002,-395613,1239487,1635100
Livestock & Livestock Products,November,2002,Q4,November 2002,-2212,839797,842009
Livestock & Livestock Products,December,2002,Q4,December 2002,-249183,976387,1225570
Livestock & Livestock Products,January,2003,Q1,January 2003,111275,1974939,1863664
Livestock & Livestock Products,February,2003,Q1,February 2003,1730572,3464251,1733679
Livestock & Livestock Products,March,2003,Q1,March 2003,-1014907,2871899,3886806
Livestock & Livestock Products,April,2003,Q2,April 2003,263874,5550572,5286698
Livestock & Livestock Products,May,2003,Q2,May 2003,-1529525,1670465,3199990
Livestock & Livestock Products,June,2003,Q2,June 2003,1811981,4309510,2497529
Livestock & Livestock Products,July,2003,Q3,July 2003,-358831,3111546,3470377
Livestock & Livestock Products,August,2003,Q3,August 2003,2157355,5140884,2983529
Livestock & Livestock Products,September,2003,Q3,September 2003,-3539489,1580107,5119596
Livestock & Livestock Products,October,2003,Q4,October 2003,-4955906,2617529,7573435
Livestock & Livestock Products,November,2003,Q4,November 2003,-2087861,2652166,4740027
Livestock & Livestock Products,December,2003,Q4,December 2003,-1717386,3106187,4823573
Livestock & Livestock Products,January,2004,Q1,January 2004,-4572675,682116,5254791
Livestock & Livestock Products,February,2004,Q1,February 2004,2789067,7280998,4491931
Livestock & Livestock Products,March,2004,Q1,March 2004,7534540,12300294,4765754
Livestock & Livestock Products,April,2004,Q2,April 2004,-924754,2700497,3625251
Livestock & Livestock Products,May,2004,Q2,May 2004,162254,2068422,1906168
Livestock & Livestock Products,June,2004,Q2,June 2004,3567574,7084396,3516822
Livestock & Livestock Products,July,2004,Q3,July 2004,-937946,2853608,3791554
Livestock & Livestock Products,August,2004,Q3,August 2004,172196,3109166,2936970
Livestock & Livestock Products,September,2004,Q3,September 2004,-1209707,2224121,3433828
Livestock & Livestock Products,October,2004,Q4,October 2004,-3877541,1806292,5683833
Livestock & Livestock Products,November,2004,Q4,November 2004,-2503560,2106348,4609908
Livestock & Livestock Products,December,2004,Q4,December 2004,-1541437,1587326,3128763
Livestock & Livestock Products,January,2005,Q1,January 2005,-2206647,1841999,4048646
Livestock & Livestock Products,February,2005,Q1,February 2005,-2007838,2051976,4059814
Livestock & Livestock Products,March,2005,Q1,March 2005,13414096,18216631,4802535
Livestock & Livestock Products,April,2005,Q2,April 2005,160702,3364983,3204281
Livestock & Livestock Products,May,2005,Q2,May 2005,3515775,6161984,2646209
Livestock & Livestock Products,June,2005,Q2,June 2005,9645132,14413146,4768014
Livestock & Livestock Products,July,2005,Q3,July 2005,-698585,3917387,4615972
Livestock & Livestock Products,August,2005,Q3,August 2005,-1519651,2741197,4260848
Livestock & Livestock Products,September,2005,Q3,September 2005,1315,3838092,3836777
Livestock & Livestock Products,October,2005,Q4,October 2005,304793,5280613,4975820
Livestock & Livestock Products,November,2005,Q4,November 2005,-2767405,1951397,4718802
Livestock & Livestock Products,December,2005,Q4,December 2005,-613569,2892929,3506498
Livestock & Livestock Products,January,2006,Q1,January 2006,-3162525,1565101,4727626
Livestock & Livestock Products,February,2006,Q1,February 2006,-1007231,3593898,4601129
Livestock & Livestock Products,March,2006,Q1,March 2006,16297705,21266844,4969139
Livestock & Livestock Products,April,2006,Q2,April 2006,356994,4898939,4541945
Livestock & Livestock Products,May,2006,Q2,May 2006,2937836,10454793,7516957
Livestock & Livestock Products,June,2006,Q2,June 2006,-1656237,5671107,7327344
Livestock & Livestock Products,July,2006,Q3,July 2006,-1636622,4108688,5745310
Livestock & Livestock Products,August,2006,Q3,August 2006,81345,3765938,3684593
Livestock & Livestock Products,September,2006,Q3,September 2006,70423,3040889,2970466
Livestock & Livestock Products,October,2006,Q4,October 2006,185730,3879449,3693719
Livestock & Livestock Products,November,2006,Q4,November 2006,-172783,3951769,4124552
Livestock & Livestock Products,December,2006,Q4,December 2006,-804691,3662586,4467277
Livestock & Livestock Products,January,2007,Q1,January 2007,-2648825,818422,3467247
Livestock & Livestock Products,February,2007,Q1,February 2007,-2124862,1801374,3926236
Livestock & Livestock Products,March,2007,Q1,March 2007,9541559,13731669,4190110
Livestock & Livestock Products,April,2007,Q2,April 2007,-149299,3996054,4145353
Livestock & Livestock Products,May,2007,Q2,May 2007,10978570,14705276,3726706
Livestock & Livestock Products,June,2007,Q2,June 2007,2668911,7120774,4451863
Livestock & Livestock Products,July,2007,Q3,July 2007,497037,4928115,4431078
Livestock & Livestock Products,August,2007,Q3,August 2007,223370,6330025,6106655
Livestock & Livestock Products,September,2007,Q3,September 2007,-868810,4018156,4886966
Livestock & Livestock Products,October,2007,Q4,October 2007,2586227,5841480,3255253
Livestock & Livestock Products,November,2007,Q4,November 2007,1726211,6612574,4886363
Livestock & Livestock Products,December,2007,Q4,December 2007,2121473,3423084,1301611
Livestock & Livestock Products,January,2008,Q1,January 2008,-2152342,2716604,4868946
Livestock & Livestock Products,February,2008,Q1,February 2008,12345776,13283249,937473
Livestock & Livestock Products,March,2008,Q1,March 2008,44275969,48085240,3809271
Livestock & Livestock Products,April,2008,Q2,April 2008,4190463,9878465,5688002
Livestock & Livestock Products,May,2008,Q2,May 2008,25374674,28924285,3549611
Livestock & Livestock Products,June,2008,Q2,June 2008,27110222,31079639,3969417
Livestock & Livestock Products,July,2008,Q3,July 2008,-1385712,4639973,6025685
Livestock & Livestock Products,August,2008,Q3,August 2008,-229954,5641850,5871804
Livestock & Livestock Products,September,2008,Q3,September 2008,4362823,10131893,5769070
Livestock & Livestock Products,October,2008,Q4,October 2008,-1038629,4909328,5947957
Livestock & Livestock Products,November,2008,Q4,November 2008,1660108,5974748,4314640
Livestock & Livestock Products,December,2008,Q4,December 2008,2854653,4419908,1565255
Livestock & Livestock Products,January,2009,Q1,January 2009,-557158,2234083,2791241
Livestock & Livestock Products,February,2009,Q1,February 2009,1461340,3658366,2197026
Livestock & Livestock Products,March,2009,Q1,March 2009,24866621,27796421,2929800
Livestock & Livestock Products,April,2009,Q2,April 2009,18079023,21524785,3445762
Livestock & Livestock Products,May,2009,Q2,May 2009,697720,3730986,3033266
Livestock & Livestock Products,June,2009,Q2,June 2009,39837585,43062609,3225024
Livestock & Livestock Products,July,2009,Q3,July 2009,8260806,9833876,1573070
Livestock & Livestock Products,August,2009,Q3,August 2009,2179090,4995440,2816350
Livestock & Livestock Products,September,2009,Q3,September 2009,6311952,9413763,3101811
Livestock & Livestock Products,October,2009,Q4,October 2009,5153692,8483739,3330047
Livestock & Livestock Products,November,2009,Q4,November 2009,3697594,5684255,1986661
Livestock & Livestock Products,December,2009,Q4,December 2009,3738556,5922995,2184439
Livestock & Livestock Products,January,2010,Q1,January 2010,-41548,3658538,3700086
Livestock & Livestock Products,February,2010,Q1,February 2010,4870263,6667274,1797011
Livestock & Livestock Products,March,2010,Q1,March 2010,65356652,69344499,3987847
Livestock & Livestock Products,April,2010,Q2,April 2010,14742697,18849650,4106953
Livestock & Livestock Products,May,2010,Q2,May 2010,13796683,17144625,3347942
Livestock & Livestock Products,June,2010,Q2,June 2010,37471441,41578617,4107176
Livestock & Livestock Products,July,2010,Q3,July 2010,4147085,8122760,3975675
Livestock & Livestock Products,August,2010,Q3,August 2010,7647369,10295703,2648334
Livestock & Livestock Products,September,2010,Q3,September 2010,3069908,6085931,3016023
Livestock & Livestock Products,October,2010,Q4,October 2010,6653822,8582605,1928783
Livestock & Livestock Products,November,2010,Q4,November 2010,7263263,9308587,2045324
Livestock & Livestock Products,December,2010,Q4,December 2010,5631735,8121727,2489992
Livestock & Livestock Products,January,2011,Q1,January 2011,-2110203,2160354,4270557
Livestock & Livestock Products,February,2011,Q1,February 2011,1453049,4673797,3220748
Livestock & Livestock Products,March,2011,Q1,March 2011,33858199,36697110,2838911
Livestock & Livestock Products,April,2011,Q2,April 2011,58959545,62720973,3761428
Livestock & Livestock Products,May,2011,Q2,May 2011,16945682,20881922,3936240
Livestock & Livestock Products,June,2011,Q2,June 2011,32784403,35942075,3157672
Livestock & Livestock Products,July,2011,Q3,July 2011,2511605,6688446,4176841
Livestock & Livestock Products,August,2011,Q3,August 2011,10277685,12240200,1962515
Livestock & Livestock Products,September,2011,Q3,September 2011,4487422,8803770,4316348
Livestock & Livestock Products,October,2011,Q4,October 2011,6521976,9116824,2594848
Livestock & Livestock Products,November,2011,Q4,November 2011,3948247,6598958,2650711
Livestock & Livestock Products,December,2011,Q4,December 2011,8377880,10134333,1756453
Livestock & Livestock Products,January,2012,Q1,January 2012,5342341,6354966,1012625
Livestock & Livestock Products,February,2012,Q1,February 2012,8837760,11062738,2224978
Livestock & Livestock Products,March,2012,Q1,March 2012,11185042,12899065,1714023
Livestock & Livestock Products,April,2012,Q2,April 2012,59526039,62647104,3121065
Livestock & Livestock Products,May,2012,Q2,May 2012,14294940,17007051,2712111
Livestock & Livestock Products,June,2012,Q2,June 2012,51349803,53387753,2037950
Livestock & Livestock Products,July,2012,Q3,July 2012,8736064,11424310,2688246
Livestock & Livestock Products,August,2012,Q3,August 2012,12856020,14469380,1613360
Livestock & Livestock Products,September,2012,Q3,September 2012,5461849,8058438,2596589
Livestock & Livestock Products,October,2012,Q4,October 2012,8943680,10181191,1237511
Livestock & Livestock Products,November,2012,Q4,November 2012,11155359,12512082,1356723
Livestock & Livestock Products,December,2012,Q4,December 2012,6925040,9480938,2555898
Livestock & Livestock Products,January,2013,Q1,January 2013,10159602,11995395,1835793
Livestock & Livestock Products,February,2013,Q1,February 2013,4036735,6740946,2704211
Livestock & Livestock Products,March,2013,Q1,March 2013,12680737,14151564,1470827
Livestock & Livestock Products,April,2013,Q2,April 2013,72708929,73371078,662149
Livestock & Livestock Products,May,2013,Q2,May 2013,29847877,30566918,719041
Livestock & Livestock Products,June,2013,Q2,June 2013,55519503,59884002,4364499
Livestock & Livestock Products,July,2013,Q3,July 2013,14149204,18106335,3957131
Livestock & Livestock Products,August,2013,Q3,August 2013,18704195,21458060,2753865
Livestock & Livestock Products,September,2013,Q3,September 2013,8794967,11765199,2970232
Livestock & Livestock Products,October,2013,Q4,October 2013,13217129,14966202,1749073
Livestock & Livestock Products,November,2013,Q4,November 2013,13415754,13900288,484534
Livestock & Livestock Products,December,2013,Q4,December 2013,10680202,15743589,5063387
Livestock & Livestock Products,January,2014,Q1,January 2014,2621251,3698708,1077457
Livestock & Livestock Products,February,2014,Q1,February 2014,2986253,4384226,1397973
Livestock & Livestock Products,March,2014,Q1,March 2014,1891343,9584193,7692850
Livestock & Livestock Products,April,2014,Q2,April 2014,22770388,24474950,1704562
Livestock & Livestock Products,May,2014,Q2,May 2014,12541613,14907141,2365528
Livestock & Livestock Products,June,2014,Q2,June 2014,10709537,17119623,6410086
Livestock & Livestock Products,July,2014,Q3,July 2014,10882912,16279105,5396193
Livestock & Livestock Products,August,2014,Q3,August 2014,14198267,16257730,2059463
Livestock & Livestock Products,September,2014,Q3,September 2014,3608325,8106183,4497858
Livestock & Livestock Products,October,2014,Q4,October 2014,7229948,10974480,3744532
Livestock & Livestock Products,November,2014,Q4,November 2014,5390948,8529862,3138914
Livestock & Livestock Products,December,2014,Q4,December 2014,10016581,13980598,3964017
Livestock & Livestock Products,January,2015,Q1,January 2015,2254354,3176711,922357
Livestock & Livestock Products,February,2015,Q1,February 2015,6066388,6756967,690579
Livestock & Livestock Products,March,2015,Q1,March 2015,4015138,7218091,3202953
Livestock & Livestock Products,April,2015,Q2,April 2015,60344543,64746401,4401858
Livestock & Livestock Products,May,2015,Q2,May 2015,18707668,19786609,1078941
Livestock & Livestock Products,June,2015,Q2,June 2015,22859925,27116623,4256698
Livestock & Livestock Products,July,2015,Q3,July 2015,27819875,29473225,1653350
Livestock & Livestock Products,August,2015,Q3,August 2015,5987933,9444490,3456557
Livestock & Livestock Products,September,2015,Q3,September 2015,7985716,11132403,3146687
Livestock & Livestock Products,October,2015,Q4,October 2015,1409520,5494814,4085294
Livestock & Livestock Products,November,2015,Q4,November 2015,4456000,6380118,1924118
Livestock & Livestock Products,December,2015,Q4,December 2015,6818108,7801544,983436
Livestock & Livestock Products,January,2016,Q1,January 2016,1456754,5196912,3740158
Livestock & Livestock Products,February,2016,Q1,February 2016,3024496,6650323,3625827
Livestock & Livestock Products,March,2016,Q1,March 2016,14456739,18850981,4394242
Livestock & Livestock Products,April,2016,Q2,April 2016,31609125,36165424,4556299
Livestock & Livestock Products,May,2016,Q2,May 2016,3188109,6614136,3426027
Livestock & Livestock Products,June,2016,Q2,June 2016,8753804,13654643,4900839
Livestock & Livestock Products,July,2016,Q3,July 2016,26715017,30377631,3662614
Livestock & Livestock Products,August,2016,Q3,August 2016,-133511,3512339,3645850
Livestock & Livestock Products,September,2016,Q3,September 2016,-466287,4748394,5214681
Livestock & Livestock Products,October,2016,Q4,October 2016,1355187,2772036,1416849
Livestock & Livestock Products,November,2016,Q4,November 2016,-907141,3600176,4507317
Livestock & Livestock Products,December,2016,Q4,December 2016,-330586,3987159,4317745
Livestock & Livestock Products,January,2017,Q1,January 2017,1898447,2639436,740989
Livestock & Livestock Products,February,2017,Q1,February 2017,902663,3102663,2200000
Livestock & Livestock Products,March,2017,Q1,March 2017,13010093,15746907,2736814
Livestock & Livestock Products,April,2017,Q2,April 2017,9142991,13658113,4515122
Livestock & Livestock Products,May,2017,Q2,May 2017,1871837,4897302,3025465
Livestock & Livestock Products,June,2017,Q2,June 2017,8683652,12143732,3460080
Livestock & Livestock Products,July,2017,Q3,July 2017,26714565,29799055,3084490
Livestock & Livestock Products,August,2017,Q3,August 2017,2818610,5884479,3065869
Livestock & Livestock Products,September,2017,Q3,September 2017,-136564,2893294,3029858
Livestock & Livestock Products,October,2017,Q4,October 2017,3206095,6269721,3063626
Livestock & Livestock Products,November,2017,Q4,November 2017,-1157603,3245088,4402691
Livestock & Livestock Products,December,2017,Q4,December 2017,4860886,8893839,4032953
Livestock & Livestock Products,January,2018,Q1,January 2018,-1435873,1873288,3309161
Livestock & Livestock Products,February,2018,Q1,February 2018,89310,1243917,1154607
Livestock & Livestock Products,March,2018,Q1,March 2018,746531,5450441,4703910
Livestock & Livestock Products,April,2018,Q2,April 2018,712863,5110914,4398051
Livestock & Livestock Products,May,2018,Q2,May 2018,3752551,7732494,3979943
Livestock & Livestock Products,June,2018,Q2,June 2018,1989841,5833582,3843741
Livestock & Livestock Products,July,2018,Q3,July 2018,3467706,6693611,3225905
Livestock & Livestock Products,August,2018,Q3,August 2018,-77156,4383005,4460161
Livestock & Livestock Products,September,2018,Q3,September 2018,-665836,4486531,5152367
Livestock & Livestock Products,October,2018,Q4,October 2018,-140416,4195744,4336160
Livestock & Livestock Products,November,2018,Q4,November 2018,-1227664,2452996,3680660
Livestock & Livestock Products,December,2018,Q4,December 2018,-1540809,3468256,5009065
Livestock & Livestock Products,January,2019,Q1,January 2019,838550,3596461,2757911
Livestock & Livestock Products,February,2019,Q1,February 2019,-570780,996932,1567712
Livestock & Livestock Products,March,2019,Q1,March 2019,-831605,3256937,4088542
Livestock & Livestock Products,April,2019,Q2,April 2019,3668556,4240062,571506
Livestock & Livestock Products,May,2019,Q2,May 2019,1469561,6443439,4973878
Livestock & Livestock Products,June,2019,Q2,June 2019,1850731,4184053,2333322
Livestock & Livestock Products,July,2019,Q3,July 2019,-279276,3141747,3421023
Livestock & Livestock Products,August,2019,Q3,August 2019,3391131,6258343,2867212
Livestock & Livestock Products,September,2019,Q3,September 2019,-1513485,3837629,5351114
Livestock & Livestock Products,October,2019,Q4,October 2019,4412456,5395903,983447
Livestock & Livestock Products,November,2019,Q4,November 2019,1907400,6310758,4403358
Livestock & Livestock Products,December,2019,Q4,December 2019,486154,5054043,4567889
"Forestry Products, Nesoi",January,2002,Q1,January 2002,-317289,2986700,3303989
"Forestry Products, Nesoi",February,2002,Q1,February 2002,1707376,5802760,4095384
"Forestry Products, Nesoi",March,2002,Q1,March 2002,1374338,5552252,4177914
"Forestry Products, Nesoi",April,2002,Q2,April 2002,3836359,7469797,3633438
"Forestry Products, Nesoi",May,2002,Q2,May 2002,3897985,7577774,3679789
"Forestry Products, Nesoi",June,2002,Q2,June 2002,3578766,7605465,4026699
"Forestry Products, Nesoi",July,2002,Q3,July 2002,1485535,6589056,5103521
"Forestry Products, Nesoi",August,2002,Q3,August 2002,-86440,4691622,4778062
"Forestry Products, Nesoi",September,2002,Q3,September 2002,-164273,5145393,5309666
"Forestry Products, Nesoi",October,2002,Q4,October 2002,3561104,7116419,3555315
"Forestry Products, Nesoi",November,2002,Q4,November 2002,6144712,10376770,4232058
"Forestry Products, Nesoi",December,2002,Q4,December 2002,1994556,7080926,5086370
"Forestry Products, Nesoi",January,2003,Q1,January 2003,233310,6607841,6374531
"Forestry Products, Nesoi",February,2003,Q1,February 2003,2814630,7434047,4619417
"Forestry Products, Nesoi",March,2003,Q1,March 2003,6368286,12141933,5773647
"Forestry Products, Nesoi",April,2003,Q2,April 2003,6762576,11085740,4323164
"Forestry Products, Nesoi",May,2003,Q2,May 2003,3241122,8020552,4779430
"Forestry Products, Nesoi",June,2003,Q2,June 2003,1228248,5917081,4688833
"Forestry Products, Nesoi",July,2003,Q3,July 2003,1856175,6626039,4769864
"Forestry Products, Nesoi",August,2003,Q3,August 2003,2257207,6073804,3816597
"Forestry Products, Nesoi",September,2003,Q3,September 2003,2189239,7374200,5184961
"Forestry Products, Nesoi",October,2003,Q4,October 2003,6102829,10777026,4674197
"Forestry Products, Nesoi",November,2003,Q4,November 2003,14552175,19466900,4914725
"Forestry Products, Nesoi",December,2003,Q4,December 2003,10324984,14899176,4574192
"Forestry Products, Nesoi",January,2004,Q1,January 2004,6076311,10581646,4505335
"Forestry Products, Nesoi",February,2004,Q1,February 2004,5173183,9737524,4564341
"Forestry Products, Nesoi",March,2004,Q1,March 2004,8061629,13712903,5651274
"Forestry Products, Nesoi",April,2004,Q2,April 2004,7307016,13677289,6370273
"Forestry Products, Nesoi",May,2004,Q2,May 2004,8344026,13988352,5644326
"Forestry Products, Nesoi",June,2004,Q2,June 2004,4681327,11016658,6335331
"Forestry Products, Nesoi",July,2004,Q3,July 2004,4369057,10223952,5854895
"Forestry Products, Nesoi",August,2004,Q3,August 2004,4528015,9141366,4613351
"Forestry Products, Nesoi",September,2004,Q3,September 2004,1579576,6444712,4865136
"Forestry Products, Nesoi",October,2004,Q4,October 2004,3600188,9233441,5633253
"Forestry Products, Nesoi",November,2004,Q4,November 2004,4618799,10504730,5885931
"Forestry Products, Nesoi",December,2004,Q4,December 2004,6406991,13209507,6802516
"Forestry Products, Nesoi",January,2005,Q1,January 2005,4818072,11572097,6754025
"Forestry Products, Nesoi",February,2005,Q1,February 2005,8507726,14253934,5746208
"Forestry Products, Nesoi",March,2005,Q1,March 2005,9405527,16068670,6663143
"Forestry Products, Nesoi",April,2005,Q2,April 2005,7238926,14055262,6816336
"Forestry Products, Nesoi",May,2005,Q2,May 2005,7461059,15102625,7641566
"Forestry Products, Nesoi",June,2005,Q2,June 2005,6994384,14032370,7037986
"Forestry Products, Nesoi",July,2005,Q3,July 2005,14202462,19612864,5410402
"Forestry Products, Nesoi",August,2005,Q3,August 2005,8252516,13287706,5035190
"Forestry Products, Nesoi",September,2005,Q3,September 2005,7898072,13890892,5992820
"Forestry Products, Nesoi",October,2005,Q4,October 2005,8976372,14355471,5379099
"Forestry Products, Nesoi",November,2005,Q4,November 2005,10497020,16342646,5845626
"Forestry Products, Nesoi",December,2005,Q4,December 2005,4353226,12026281,7673055
"Forestry Products, Nesoi",January,2006,Q1,January 2006,11294373,18301551,7007178
"Forestry Products, Nesoi",February,2006,Q1,February 2006,10632819,17112988,6480169
"Forestry Products, Nesoi",March,2006,Q1,March 2006,8770218,15472056,6701838
"Forestry Products, Nesoi",April,2006,Q2,April 2006,10899057,17123706,6224649
"Forestry Products, Nesoi",May,2006,Q2,May 2006,10391282,18527842,8136560
"Forestry Products, Nesoi",June,2006,Q2,June 2006,5813978,14453870,8639892
"Forestry Products, Nesoi",July,2006,Q3,July 2006,6117328,14644664,8527336
"Forestry Products, Nesoi",August,2006,Q3,August 2006,3213486,12553363,9339877
"Forestry Products, Nesoi",September,2006,Q3,September 2006,2656397,12612927,9956530
"Forestry Products, Nesoi",October,2006,Q4,October 2006,8331151,15229943,6898792
"Forestry Products, Nesoi",November,2006,Q4,November 2006,13042213,19588497,6546284
"Forestry Products, Nesoi",December,2006,Q4,December 2006,11235592,18336264,7100672
"Forestry Products, Nesoi",January,2007,Q1,January 2007,4678294,12276341,7598047
"Forestry Products, Nesoi",February,2007,Q1,February 2007,6794887,15707987,8913100
"Forestry Products, Nesoi",March,2007,Q1,March 2007,16328961,24066872,7737911
"Forestry Products, Nesoi",April,2007,Q2,April 2007,15878475,25629881,9751406
"Forestry Products, Nesoi",May,2007,Q2,May 2007,14925177,25422378,10497201
"Forestry Products, Nesoi",June,2007,Q2,June 2007,16582487,23495093,6912606
"Forestry Products, Nesoi",July,2007,Q3,July 2007,11734916,25705339,13970423
"Forestry Products, Nesoi",August,2007,Q3,August 2007,9462562,17330158,7867596
"Forestry Products, Nesoi",September,2007,Q3,September 2007,12022602,18269110,6246508
"Forestry Products, Nesoi",October,2007,Q4,October 2007,16900309,23862265,6961956
"Forestry Products, Nesoi",November,2007,Q4,November 2007,13868590,22723224,8854634
"Forestry Products, Nesoi",December,2007,Q4,December 2007,9862456,17570067,7707611
"Forestry Products, Nesoi",January,2008,Q1,January 2008,3839500,11999484,8159984
"Forestry Products, Nesoi",February,2008,Q1,February 2008,11933154,21347900,9414746
"Forestry Products, Nesoi",March,2008,Q1,March 2008,12464973,19580526,7115553
"Forestry Products, Nesoi",April,2008,Q2,April 2008,14412251,22948791,8536540
"Forestry Products, Nesoi",May,2008,Q2,May 2008,12275976,21957643,9681667
"Forestry Products, Nesoi",June,2008,Q2,June 2008,21242798,31229860,9987062
"Forestry Products, Nesoi",July,2008,Q3,July 2008,10042148,19747157,9705009
"Forestry Products, Nesoi",August,2008,Q3,August 2008,14644155,22578207,7934052
"Forestry Products, Nesoi",September,2008,Q3,September 2008,11670178,18864351,7194173
"Forestry Products, Nesoi",October,2008,Q4,October 2008,7684427,16280559,8596132
"Forestry Products, Nesoi",November,2008,Q4,November 2008,10368860,19418701,9049841
"Forestry Products, Nesoi",December,2008,Q4,December 2008,4484065,13544856,9060791
"Forestry Products, Nesoi",January,2009,Q1,January 2009,2446446,11220022,8773576
"Forestry Products, Nesoi",February,2009,Q1,February 2009,5681606,13434639,7753033
"Forestry Products, Nesoi",March,2009,Q1,March 2009,10770042,18015849,7245807
"Forestry Products, Nesoi",April,2009,Q2,April 2009,16136124,23940896,7804772
"Forestry Products, Nesoi",May,2009,Q2,May 2009,11027896,18788761,7760865
"Forestry Products, Nesoi",June,2009,Q2,June 2009,12533899,20393368,7859469
"Forestry Products, Nesoi",July,2009,Q3,July 2009,13394054,22691211,9297157
"Forestry Products, Nesoi",August,2009,Q3,August 2009,14029931,25042709,11012778
"Forestry Products, Nesoi",September,2009,Q3,September 2009,12674518,22304464,9629946
"Forestry Products, Nesoi",October,2009,Q4,October 2009,16345440,25385928,9040488
"Forestry Products, Nesoi",November,2009,Q4,November 2009,24821910,33816077,8994167
"Forestry Products, Nesoi",December,2009,Q4,December 2009,17572049,26175487,8603438
"Forestry Products, Nesoi",January,2010,Q1,January 2010,10252759,20258060,10005301
"Forestry Products, Nesoi",February,2010,Q1,February 2010,29739918,38487585,8747667
"Forestry Products, Nesoi",March,2010,Q1,March 2010,20098225,31385618,11287393
"Forestry Products, Nesoi",April,2010,Q2,April 2010,36585889,46021286,9435397
"Forestry Products, Nesoi",May,2010,Q2,May 2010,48570631,59965213,11394582
"Forestry Products, Nesoi",June,2010,Q2,June 2010,43423856,52605320,9181464
"Forestry Products, Nesoi",July,2010,Q3,July 2010,58999965,68029939,9029974
"Forestry Products, Nesoi",August,2010,Q3,August 2010,66483219,75231219,8748000
"Forestry Products, Nesoi",September,2010,Q3,September 2010,66378432,75134864,8756432
"Forestry Products, Nesoi",October,2010,Q4,October 2010,66638092,75407579,8769487
"Forestry Products, Nesoi",November,2010,Q4,November 2010,57618185,70249974,12631789
"Forestry Products, Nesoi",December,2010,Q4,December 2010,47844164,61141157,13296993
"Forestry Products, Nesoi",January,2011,Q1,January 2011,44796166,59293406,14497240
"Forestry Products, Nesoi",February,2011,Q1,February 2011,64337212,75360470,11023258
"Forestry Products, Nesoi",March,2011,Q1,March 2011,103271314,114551461,11280147
"Forestry Products, Nesoi",April,2011,Q2,April 2011,114929237,128666613,13737376
"Forestry Products, Nesoi",May,2011,Q2,May 2011,115679196,129557945,13878749
"Forestry Products, Nesoi",June,2011,Q2,June 2011,115517608,129811856,14294248
"Forestry Products, Nesoi",July,2011,Q3,July 2011,81594946,97591209,15996263
"Forestry Products, Nesoi",August,2011,Q3,August 2011,95108183,106077026,10968843
"Forestry Products, Nesoi",September,2011,Q3,September 2011,67881402,83224013,15342611
"Forestry Products, Nesoi",October,2011,Q4,October 2011,61852849,74362141,12509292
"Forestry Products, Nesoi",November,2011,Q4,November 2011,45835732,58222164,12386432
"Forestry Products, Nesoi",December,2011,Q4,December 2011,43987171,56400592,12413421
"Forestry Products, Nesoi",January,2012,Q1,January 2012,39240952,53742879,14501927
"Forestry Products, Nesoi",February,2012,Q1,February 2012,43460095,58626445,15166350
"Forestry Products, Nesoi",March,2012,Q1,March 2012,66113144,79155316,13042172
"Forestry Products, Nesoi",April,2012,Q2,April 2012,41583508,58953956,17370448
"Forestry Products, Nesoi",May,2012,Q2,May 2012,54797257,68868129,14070872
"Forestry Products, Nesoi",June,2012,Q2,June 2012,46163720,62316733,16153013
"Forestry Products, Nesoi",July,2012,Q3,July 2012,52454976,67763088,15308112
"Forestry Products, Nesoi",August,2012,Q3,August 2012,63107743,75548014,12440271
"Forestry Products, Nesoi",September,2012,Q3,September 2012,59570161,70619706,11049545
"Forestry Products, Nesoi",October,2012,Q4,October 2012,81510391,93924152,12413761
"Forestry Products, Nesoi",November,2012,Q4,November 2012,46213516,59358833,13145317
"Forestry Products, Nesoi",December,2012,Q4,December 2012,71993919,85527470,13533551
"Forestry Products, Nesoi",January,2013,Q1,January 2013,37771327,60614160,22842833
"Forestry Products, Nesoi",February,2013,Q1,February 2013,56474828,71424719,14949891
"Forestry Products, Nesoi",March,2013,Q1,March 2013,92918153,106389706,13471553
"Forestry Products, Nesoi",April,2013,Q2,April 2013,98749013,116443108,17694095
"Forestry Products, Nesoi",May,2013,Q2,May 2013,85367336,103066639,17699303
"Forestry Products, Nesoi",June,2013,Q2,June 2013,101679716,120084752,18405036
"Forestry Products, Nesoi",July,2013,Q3,July 2013,76278586,97254715,20976129
"Forestry Products, Nesoi",August,2013,Q3,August 2013,91580866,110737407,19156541
"Forestry Products, Nesoi",September,2013,Q3,September 2013,79384000,91917062,12533062
"Forestry Products, Nesoi",October,2013,Q4,October 2013,118901200,136991700,18090500
"Forestry Products, Nesoi",November,2013,Q4,November 2013,71326501,83712974,12386473
"Forestry Products, Nesoi",December,2013,Q4,December 2013,74222002,90429906,16207904
"Forestry Products, Nesoi",January,2014,Q1,January 2014,81143111,98076036,16932925
"Forestry Products, Nesoi",February,2014,Q1,February 2014,98621499,114266033,15644534
"Forestry Products, Nesoi",March,2014,Q1,March 2014,101776056,113859641,12083585
"Forestry Products, Nesoi",April,2014,Q2,April 2014,127226574,141773947,14547373
"Forestry Products, Nesoi",May,2014,Q2,May 2014,130521698,146260154,15738456
"Forestry Products, Nesoi",June,2014,Q2,June 2014,109472032,123533572,14061540
"Forestry Products, Nesoi",July,2014,Q3,July 2014,84039107,99245162,15206055
"Forestry Products, Nesoi",August,2014,Q3,August 2014,76369534,88363285,11993751
"Forestry Products, Nesoi",September,2014,Q3,September 2014,78742963,91666828,12923865
"Forestry Products, Nesoi",October,2014,Q4,October 2014,85556461,99627460,14070999
"Forestry Products, Nesoi",November,2014,Q4,November 2014,67883084,83270271,15387187
"Forestry Products, Nesoi",December,2014,Q4,December 2014,53077145,69910389,16833244
"Forestry Products, Nesoi",January,2015,Q1,January 2015,41644692,57717113,16072421
"Forestry Products, Nesoi",February,2015,Q1,February 2015,50641812,67664530,17022718
"Forestry Products, Nesoi",March,2015,Q1,March 2015,92812438,114345584,21533146
"Forestry Products, Nesoi",April,2015,Q2,April 2015,68119812,91188933,23069121
"Forestry Products, Nesoi",May,2015,Q2,May 2015,66701342,89400382,22699040
"Forestry Products, Nesoi",June,2015,Q2,June 2015,67484604,89978876,22494272
"Forestry Products, Nesoi",July,2015,Q3,July 2015,53625888,74145704,20519816
"Forestry Products, Nesoi",August,2015,Q3,August 2015,36867047,58588183,21721136
"Forestry Products, Nesoi",September,2015,Q3,September 2015,30044173,47299328,17255155
"Forestry Products, Nesoi",October,2015,Q4,October 2015,38190627,56628400,18437773
"Forestry Products, Nesoi",November,2015,Q4,November 2015,81880563,95860250,13979687
"Forestry Products, Nesoi",December,2015,Q4,December 2015,31107123,52814307,21707184
"Forestry Products, Nesoi",January,2016,Q1,January 2016,21828989,48540319,26711330
"Forestry Products, Nesoi",February,2016,Q1,February 2016,51695427,70068161,18372734
"Forestry Products, Nesoi",March,2016,Q1,March 2016,51650143,69260400,17610257
"Forestry Products, Nesoi",April,2016,Q2,April 2016,55769386,82920007,27150621
"Forestry Products, Nesoi",May,2016,Q2,May 2016,81587721,108035730,26448009
"Forestry Products, Nesoi",June,2016,Q2,June 2016,90234907,117056611,26821704
"Forestry Products, Nesoi",July,2016,Q3,July 2016,59650462,80820385,21169923
"Forestry Products, Nesoi",August,2016,Q3,August 2016,84615938,101769820,17153882
"Forestry Products, Nesoi",September,2016,Q3,September 2016,93230970,108599293,15368323
"Forestry Products, Nesoi",October,2016,Q4,October 2016,69123829,85478020,16354191
"Forestry Products, Nesoi",November,2016,Q4,November 2016,82617597,95786921,13169324
"Forestry Products, Nesoi",December,2016,Q4,December 2016,67093089,86439338,19346249
"Forestry Products, Nesoi",January,2017,Q1,January 2017,50053712,81382052,31328340
"Forestry Products, Nesoi",February,2017,Q1,February 2017,71637234,87124175,15486941
"Forestry Products, Nesoi",March,2017,Q1,March 2017,86566438,104173957,17607519
"Forestry Products, Nesoi",April,2017,Q2,April 2017,94832338,112934082,18101744
"Forestry Products, Nesoi",May,2017,Q2,May 2017,90816979,109868333,19051354
"Forestry Products, Nesoi",June,2017,Q2,June 2017,95797425,112734770,16937345
"Forestry Products, Nesoi",July,2017,Q3,July 2017,98930753,120462324,21531571
"Forestry Products, Nesoi",August,2017,Q3,August 2017,91417180,108752022,17334842
"Forestry Products, Nesoi",September,2017,Q3,September 2017,97846651,118239935,20393284
"Forestry Products, Nesoi",October,2017,Q4,October 2017,109547949,126120212,16572263
"Forestry Products, Nesoi",November,2017,Q4,November 2017,95780739,114223703,18442964
"Forestry Products, Nesoi",December,2017,Q4,December 2017,99656902,120060582,20403680
"Forestry Products, Nesoi",January,2018,Q1,January 2018,57453197,80903332,23450135
"Forestry Products, Nesoi",February,2018,Q1,February 2018,109124962,123503242,14378280
"Forestry Products, Nesoi",March,2018,Q1,March 2018,106666095,129390712,22724617
"Forestry Products, Nesoi",April,2018,Q2,April 2018,148326002,165553582,17227580
"Forestry Products, Nesoi",May,2018,Q2,May 2018,86150109,108212733,22062624
"Forestry Products, Nesoi",June,2018,Q2,June 2018,102946069,126489569,23543500
"Forestry Products, Nesoi",July,2018,Q3,July 2018,96517353,120073286,23555933
"Forestry Products, Nesoi",August,2018,Q3,August 2018,94136192,114792778,20656586
"Forestry Products, Nesoi",September,2018,Q3,September 2018,61989209,80400788,18411579
"Forestry Products, Nesoi",October,2018,Q4,October 2018,53659807,75892672,22232865
"Forestry Products, Nesoi",November,2018,Q4,November 2018,80941798,102811274,21869476
"Forestry Products, Nesoi",December,2018,Q4,December 2018,41448447,66641936,25193489
"Forestry Products, Nesoi",January,2019,Q1,January 2019,40402326,64642891,24240565
"Forestry Products, Nesoi",February,2019,Q1,February 2019,36644424,54314323,17669899
"Forestry Products, Nesoi",March,2019,Q1,March 2019,51738662,70205523,18466861
"Forestry Products, Nesoi",April,2019,Q2,April 2019,63744874,90882613,27137739
"Forestry Products, Nesoi",May,2019,Q2,May 2019,56561548,86598097,30036549
"Forestry Products, Nesoi",June,2019,Q2,June 2019,50601906,79547231,28945325
"Forestry Products, Nesoi",July,2019,Q3,July 2019,24896147,50847860,25951713
"Forestry Products, Nesoi",August,2019,Q3,August 2019,22944014,57984482,35040468
"Forestry Products, Nesoi",September,2019,Q3,September 2019,22188815,39203911,17015096
"Forestry Products, Nesoi",October,2019,Q4,October 2019,33707840,43851423,10143583
"Forestry Products, Nesoi",November,2019,Q4,November 2019,38647220,49966343,11319123
"Forestry Products, Nesoi",December,2019,Q4,December 2019,21887106,35928460,14041354
Marine Products,January,2002,Q1,January 2002,-49095144,7364455,56459599
Marine Products,February,2002,Q1,February 2002,-40760789,11026880,51787669
Marine Products,March,2002,Q1,March 2002,-21239122,14567243,35806365
Marine Products,April,2002,Q2,April 2002,-28256458,15469622,43726080
Marine Products,May,2002,Q2,May 2002,-42411818,7501765,49913583
Marine Products,June,2002,Q2,June 2002,-40792643,7945987,48738630
Marine Products,July,2002,Q3,July 2002,-44860919,13509378,58370297
Marine Products,August,2002,Q3,August 2002,-57593476,19476015,77069491
Marine Products,September,2002,Q3,September 2002,-56475734,16632862,73108596
Marine Products,October,2002,Q4,October 2002,-59396567,14051937,73448504
Marine Products,November,2002,Q4,November 2002,-85595928,12515725,98111653
Marine Products,December,2002,Q4,December 2002,-98607995,6162653,104770648
Marine Products,January,2003,Q1,January 2003,-81916430,5345044,87261474
Marine Products,February,2003,Q1,February 2003,-46378368,18034112,64412480
Marine Products,March,2003,Q1,March 2003,-18832873,19226673,38059546
Marine Products,April,2003,Q2,April 2003,-28621284,27611267,56232551
Marine Products,May,2003,Q2,May 2003,-39641836,16597859,56239695
Marine Products,June,2003,Q2,June 2003,-56420874,8945688,65366562
Marine Products,July,2003,Q3,July 2003,-81718496,16946789,98665285
Marine Products,August,2003,Q3,August 2003,-79728564,26853896,106582460
Marine Products,September,2003,Q3,September 2003,-74733614,26246168,100979782
Marine Products,October,2003,Q4,October 2003,-97986171,15326401,113312572
Marine Products,November,2003,Q4,November 2003,-98051108,16394581,114445689
Marine Products,December,2003,Q4,December 2003,-101197620,11286508,112484128
Marine Products,January,2004,Q1,January 2004,-105731541,6050704,111782245
Marine Products,February,2004,Q1,February 2004,-61353460,35611420,96964880
Marine Products,March,2004,Q1,March 2004,-45247969,31134712,76382681
Marine Products,April,2004,Q2,April 2004,-31921668,32073054,63994722
Marine Products,May,2004,Q2,May 2004,-46936277,18690702,65626979
Marine Products,June,2004,Q2,June 2004,-51681895,12502337,64184232
Marine Products,July,2004,Q3,July 2004,-39029001,28674595,67703596
Marine Products,August,2004,Q3,August 2004,-30232348,42013303,72245651
Marine Products,September,2004,Q3,September 2004,-67919973,31969720,99889693
Marine Products,October,2004,Q4,October 2004,-84336348,23529952,107866300
Marine Products,November,2004,Q4,November 2004,-111498280,17037832,128536112
Marine Products,December,2004,Q4,December 2004,-95490771,16902403,112393174
Marine Products,January,2005,Q1,January 2005,-101014614,17639522,118654136
Marine Products,February,2005,Q1,February 2005,-66813023,31043012,97856035
Marine Products,March,2005,Q1,March 2005,-6294064,54787257,61081321
Marine Products,April,2005,Q2,April 2005,-26653755,41488125,68141880
Marine Products,May,2005,Q2,May 2005,-59074931,32628102,91703033
Marine Products,June,2005,Q2,June 2005,-65625163,21265454,86890617
Marine Products,July,2005,Q3,July 2005,-53373563,38018741,91392304
Marine Products,August,2005,Q3,August 2005,-47689363,74949552,122638915
Marine Products,September,2005,Q3,September 2005,-75146187,29354540,104500727
Marine Products,October,2005,Q4,October 2005,-91693214,15034114,106727328
Marine Products,November,2005,Q4,November 2005,-121056047,11504176,132560223
Marine Products,December,2005,Q4,December 2005,-135675008,20818994,156494002
Marine Products,January,2006,Q1,January 2006,-140854676,11166112,152020788
Marine Products,February,2006,Q1,February 2006,-88282889,29286769,117569658
Marine Products,March,2006,Q1,March 2006,-15397712,61011304,76409016
Marine Products,April,2006,Q2,April 2006,-62487114,55584637,118071751
Marine Products,May,2006,Q2,May 2006,-101923813,32239762,134163575
Marine Products,June,2006,Q2,June 2006,-110728036,28954254,139682290
Marine Products,July,2006,Q3,July 2006,-87058907,49822753,136881660
Marine Products,August,2006,Q3,August 2006,-56358193,86377186,142735379
Marine Products,September,2006,Q3,September 2006,-113101722,54655701,167757423
Marine Products,October,2006,Q4,October 2006,-125838967,32342792,158181759
Marine Products,November,2006,Q4,November 2006,-154913901,14316657,169230558
Marine Products,December,2006,Q4,December 2006,-169507630,12749506,182257136
Marine Products,January,2007,Q1,January 2007,-204382991,11868169,216251160
Marine Products,February,2007,Q1,February 2007,-130064701,34142612,164207313
Marine Products,March,2007,Q1,March 2007,-76568138,44364980,120933118
Marine Products,April,2007,Q2,April 2007,-29212532,68180162,97392694
Marine Products,May,2007,Q2,May 2007,-106635498,36857772,143493270
Marine Products,June,2007,Q2,June 2007,-85789615,39713168,125502783
Marine Products,July,2007,Q3,July 2007,-50657765,86689981,137347746
Marine Products,August,2007,Q3,August 2007,-30600864,110048428,140649292
Marine Products,September,2007,Q3,September 2007,-67949885,63319491,131269376
Marine Products,October,2007,Q4,October 2007,-102585156,30963528,133548684
Marine Products,November,2007,Q4,November 2007,-136721436,18816021,155537457
Marine Products,December,2007,Q4,December 2007,-152522296,18687585,171209881
Marine Products,January,2008,Q1,January 2008,-161224444,17565761,178790205
Marine Products,February,2008,Q1,February 2008,-124867760,42865878,167733638
Marine Products,March,2008,Q1,March 2008,-27901234,72678487,100579721
Marine Products,April,2008,Q2,April 2008,-42978816,44150438,87129254
Marine Products,May,2008,Q2,May 2008,-94541152,42052015,136593167
Marine Products,June,2008,Q2,June 2008,-122144306,31489413,153633719
Marine Products,July,2008,Q3,July 2008,-82690401,71088889,153779290
Marine Products,August,2008,Q3,August 2008,-68125527,91506696,159632223
Marine Products,September,2008,Q3,September 2008,-104602766,57272242,161875008
Marine Products,October,2008,Q4,October 2008,-133387069,42943915,176330984
Marine Products,November,2008,Q4,November 2008,-139162817,42166346,181329163
Marine Products,December,2008,Q4,December 2008,-185518579,21420212,206938791
Marine Products,January,2009,Q1,January 2009,-195892147,10648295,206540442
Marine Products,February,2009,Q1,February 2009,-114929717,29255937,144185654
Marine Products,March,2009,Q1,March 2009,-19459585,69562412,89021997
Marine Products,April,2009,Q2,April 2009,-74613589,51829833,126443422
Marine Products,May,2009,Q2,May 2009,-118602686,33691130,152293816
Marine Products,June,2009,Q2,June 2009,-82904506,39478608,122383114
Marine Products,July,2009,Q3,July 2009,-71195374,72186974,143382348
Marine Products,August,2009,Q3,August 2009,-14104984,118102844,132207828
Marine Products,September,2009,Q3,September 2009,-68752154,69674402,138426556
Marine Products,October,2009,Q4,October 2009,-104088707,51456616,155545323
Marine Products,November,2009,Q4,November 2009,-119530068,30782074,150312142
Marine Products,December,2009,Q4,December 2009,-135429265,37795930,173225195
Marine Products,January,2010,Q1,January 2010,-170193981,20427472,190621453
Marine Products,February,2010,Q1,February 2010,-114251260,50149911,164401171
Marine Products,March,2010,Q1,March 2010,-42946663,58995872,101942535
Marine Products,April,2010,Q2,April 2010,-39926879,61909691,101836570
Marine Products,May,2010,Q2,May 2010,-112517574,44368391,156885965
Marine Products,June,2010,Q2,June 2010,-106605701,49174765,155780466
Marine Products,July,2010,Q3,July 2010,-99163533,47164300,146327833
Marine Products,August,2010,Q3,August 2010,-47728390,126391829,174120219
Marine Products,September,2010,Q3,September 2010,-47584110,127086643,174670753
Marine Products,October,2010,Q4,October 2010,-119604930,65321474,184926404
Marine Products,November,2010,Q4,November 2010,-125263439,71176369,196439808
Marine Products,December,2010,Q4,December 2010,-189825791,58253773,248079564
Marine Products,January,2011,Q1,January 2011,-248751496,28219009,276970505
Marine Products,February,2011,Q1,February 2011,-129058486,76683675,205742161
Marine Products,March,2011,Q1,March 2011,7110970,100122382,93011412
Marine Products,April,2011,Q2,April 2011,-38270673,94027489,132298162
Marine Products,May,2011,Q2,May 2011,-81987070,80512934,162500004
Marine Products,June,2011,Q2,June 2011,-108538986,59277680,167816666
Marine Products,July,2011,Q3,July 2011,-50619810,103988133,154607943
Marine Products,August,2011,Q3,August 2011,3657022,192466894,188809872
Marine Products,September,2011,Q3,September 2011,-27066199,177885282,204951481
Marine Products,October,2011,Q4,October 2011,-81078095,108865525,189943620
Marine Products,November,2011,Q4,November 2011,-112811212,97627944,210439156
Marine Products,December,2011,Q4,December 2011,-158795556,77230065,236025621
Marine Products,January,2012,Q1,January 2012,-246503165,41065631,287568796
Marine Products,February,2012,Q1,February 2012,-83548203,95951447,179499650
Marine Products,March,2012,Q1,March 2012,19463904,113555293,94091389
Marine Products,April,2012,Q2,April 2012,-49721027,112015592,161736619
Marine Products,May,2012,Q2,May 2012,-104055175,84223016,188278191
Marine Products,June,2012,Q2,June 2012,-74165167,102713590,176878757
Marine Products,July,2012,Q3,July 2012,-81573681,89313377,170887058
Marine Products,August,2012,Q3,August 2012,8022077,167829797,159807720
Marine Products,September,2012,Q3,September 2012,-11482331,141452322,152934653
Marine Products,October,2012,Q4,October 2012,-78356876,91681384,170038260
Marine Products,November,2012,Q4,November 2012,-90104615,90984543,181089158
Marine Products,December,2012,Q4,December 2012,-123077192,74628853,197706045
Marine Products,January,2013,Q1,January 2013,-186900644,29629400,216530044
Marine Products,February,2013,Q1,February 2013,-76096524,104020485,180117009
Marine Products,March,2013,Q1,March 2013,-18928113,103471683,122399796
Marine Products,April,2013,Q2,April 2013,-1976508,110519373,112495881
Marine Products,May,2013,Q2,May 2013,-110951585,69765752,180717337
Marine Products,June,2013,Q2,June 2013,-91778227,71687430,163465657
Marine Products,July,2013,Q3,July 2013,-89300537,86557805,175858342
Marine Products,August,2013,Q3,August 2013,-48976632,143760748,192737380
Marine Products,September,2013,Q3,September 2013,25133238,188185937,163052699
Marine Products,October,2013,Q4,October 2013,-57357587,124413781,181771368
Marine Products,November,2013,Q4,November 2013,-96607772,91723540,188331312
Marine Products,December,2013,Q4,December 2013,-205885485,55342414,261227899
Marine Products,January,2014,Q1,January 2014,-259063785,34042391,293106176
Marine Products,February,2014,Q1,February 2014,-122910836,84303552,207214388
Marine Products,March,2014,Q1,March 2014,11505046,131443507,119938461
Marine Products,April,2014,Q2,April 2014,-28237247,112766835,141004082
Marine Products,May,2014,Q2,May 2014,-85617942,105588526,191206468
Marine Products,June,2014,Q2,June 2014,-123446658,72990903,196437561
Marine Products,July,2014,Q3,July 2014,-101254434,99757968,201012402
Marine Products,August,2014,Q3,August 2014,4819432,186969333,182149901
Marine Products,September,2014,Q3,September 2014,-39964998,143643990,183608988
Marine Products,October,2014,Q4,October 2014,-59893433,119572602,179466035
Marine Products,November,2014,Q4,November 2014,-109529492,92251552,201781044
Marine Products,December,2014,Q4,December 2014,-149264328,63745233,213009561
Marine Products,January,2015,Q1,January 2015,-227053560,36936496,263990056
Marine Products,February,2015,Q1,February 2015,-127402886,82619135,210022021
Marine Products,March,2015,Q1,March 2015,-68249790,124881400,193131190
Marine Products,April,2015,Q2,April 2015,-7331460,79201160,86532620
Marine Products,May,2015,Q2,May 2015,-44784606,94261853,139046459
Marine Products,June,2015,Q2,June 2015,-120579643,48367484,168947127
Marine Products,July,2015,Q3,July 2015,-74320700,80226762,154547462
Marine Products,August,2015,Q3,August 2015,9014524,170171437,161156913
Marine Products,September,2015,Q3,September 2015,1567184,156615933,155048749
Marine Products,October,2015,Q4,October 2015,-49983959,95587322,145571281
Marine Products,November,2015,Q4,November 2015,-82016377,83318078,165334455
Marine Products,December,2015,Q4,December 2015,-167495957,48774725,216270682
Marine Products,January,2016,Q1,January 2016,-206978666,31250163,238228829
Marine Products,February,2016,Q1,February 2016,-147701638,79944544,227646182
Marine Products,March,2016,Q1,March 2016,-9264049,108542250,117806299
Marine Products,April,2016,Q2,April 2016,-7052577,89263836,96316413
Marine Products,May,2016,Q2,May 2016,-49591185,88630919,138222104
Marine Products,June,2016,Q2,June 2016,-91706657,70732971,162439628
Marine Products,July,2016,Q3,July 2016,-32962816,111053742,144016558
Marine Products,August,2016,Q3,August 2016,-55513884,127409734,182923618
Marine Products,September,2016,Q3,September 2016,-40999791,112609636,153609427
Marine Products,October,2016,Q4,October 2016,-51196145,104111332,155307477
Marine Products,November,2016,Q4,November 2016,-116390692,62943372,179334064
Marine Products,December,2016,Q4,December 2016,-137165240,68814194,205979434
Marine Products,January,2017,Q1,January 2017,-192745787,47933987,240679774
Marine Products,February,2017,Q1,February 2017,-130581525,63080108,193661633
Marine Products,March,2017,Q1,March 2017,38774327,127534331,88760004
Marine Products,April,2017,Q2,April 2017,-22736563,125553339,148289902
Marine Products,May,2017,Q2,May 2017,-116056966,70810604,186867570
Marine Products,June,2017,Q2,June 2017,-110457026,74055678,184512704
Marine Products,July,2017,Q3,July 2017,-80796643,109155536,189952179
Marine Products,August,2017,Q3,August 2017,-11968784,181608308,193577092
Marine Products,September,2017,Q3,September 2017,16927059,194734860,177807801
Marine Products,October,2017,Q4,October 2017,-52532623,132594053,185126676
Marine Products,November,2017,Q4,November 2017,-75258469,91279025,166537494
Marine Products,December,2017,Q4,December 2017,-102296428,103126951,205423379
Marine Products,January,2018,Q1,January 2018,-173916844,57097789,231014633
Marine Products,February,2018,Q1,February 2018,-91201599,101940842,193142441
Marine Products,March,2018,Q1,March 2018,-29349202,124640475,153989677
Marine Products,April,2018,Q2,April 2018,37979662,120642146,82662484
Marine Products,May,2018,Q2,May 2018,-48925803,99527151,148452954
Marine Products,June,2018,Q2,June 2018,-82377053,94283455,176660508
Marine Products,July,2018,Q3,July 2018,-104383918,84807452,189191370
Marine Products,August,2018,Q3,August 2018,-95527510,121121260,216648770
Marine Products,September,2018,Q3,September 2018,-81011166,124883047,205894213
Marine Products,October,2018,Q4,October 2018,-93931034,85800007,179731041
Marine Products,November,2018,Q4,November 2018,-122155629,78490894,200646523
Marine Products,December,2018,Q4,December 2018,-228463081,52353065,280816146
Marine Products,January,2019,Q1,January 2019,-105036500,40332011,145368511
Marine Products,February,2019,Q1,February 2019,-78846950,69893313,148740263
Marine Products,March,2019,Q1,March 2019,12227668,105300803,93073135
Marine Products,April,2019,Q2,April 2019,-2094910,83090694,85185604
Marine Products,May,2019,Q2,May 2019,-66920406,77544327,144464733
Marine Products,June,2019,Q2,June 2019,-88976441,47701416,136677857
Marine Products,July,2019,Q3,July 2019,-74854923,74864697,149719620
Marine Products,August,2019,Q3,August 2019,11520365,138401831,126881466
Marine Products,September,2019,Q3,September 2019,-29874712,98998936,128873648
Marine Products,October,2019,Q4,October 2019,-32308732,85398929,117707661
Marine Products,November,2019,Q4,November 2019,-65250749,60018832,125269581
Marine Products,December,2019,Q4,December 2019,-120919642,37178318,158097960
Oil & Gas,January,2002,Q1,January 2002,25607,25607,
Oil & Gas,February,2002,Q1,February 2002,-19487191,25685,19512876
Oil & Gas,March,2002,Q1,March 2002,-3523396,,3523396
Oil & Gas,April,2002,Q2,April 2002,-20429,,20429
Oil & Gas,May,2002,Q2,May 2002,-11785323,19792,11805115
Oil & Gas,June,2002,Q2,June 2002,-24636856,41010,24677866
Oil & Gas,July,2002,Q3,July 2002,-24635645,,24635645
Oil & Gas,August,2002,Q3,August 2002,-27680095,126802,27806897
Oil & Gas,September,2002,Q3,September 2002,343782,343782,
Oil & Gas,October,2002,Q4,October 2002,-41453956,36000,41489956
Oil & Gas,November,2002,Q4,November 2002,-16243369,244465,16487834
Oil & Gas,December,2002,Q4,December 2002,-11740126,249461,11989587
Oil & Gas,January,2003,Q1,January 2003,-16264682,57168,16321850
Oil & Gas,February,2003,Q1,February 2003,-12821662,266004,13087666
Oil & Gas,March,2003,Q1,March 2003,-6419218,186790,6606008
Oil & Gas,April,2003,Q2,April 2003,1586838,7232400,5645562
Oil & Gas,May,2003,Q2,May 2003,8076870,19150729,11073859
Oil & Gas,June,2003,Q2,June 2003,10668,10668,
Oil & Gas,July,2003,Q3,July 2003,-10776697,10620969,21397666
Oil & Gas,August,2003,Q3,August 2003,-11888819,11176,11899995
Oil & Gas,September,2003,Q3,September 2003,-20098850,73412,20172262
Oil & Gas,October,2003,Q4,October 2003,-4050202,378870,4429072
Oil & Gas,November,2003,Q4,November 2003,34176,34176,
Oil & Gas,December,2003,Q4,December 2003,46362,46362,
Oil & Gas,January,2004,Q1,January 2004,-6582683,55843,6638526
Oil & Gas,February,2004,Q1,February 2004,-34974322,22176,34996498
Oil & Gas,March,2004,Q1,March 2004,-5498000,156329,5654329
Oil & Gas,April,2004,Q2,April 2004,32092958,38263103,6170145
Oil & Gas,May,2004,Q2,May 2004,-5921196,110330,6031526
Oil & Gas,June,2004,Q2,June 2004,6321798,13606854,7285056
Oil & Gas,July,2004,Q3,July 2004,-12525628,14382706,26908334
Oil & Gas,August,2004,Q3,August 2004,-6420645,10030,6430675
Oil & Gas,September,2004,Q3,September 2004,2085653,9381872,7296219
Oil & Gas,October,2004,Q4,October 2004,-31508452,6475,31514927
Oil & Gas,November,2004,Q4,November 2004,-39307293,4951,39312244
Oil & Gas,December,2004,Q4,December 2004,-15492310,3594,15495904
Oil & Gas,January,2005,Q1,January 2005,-20955602,,20955602
Oil & Gas,February,2005,Q1,February 2005,-24341571,56006,24397577
Oil & Gas,March,2005,Q1,March 2005,-32164146,107647,32271793
Oil & Gas,April,2005,Q2,April 2005,-37548899,,37548899
Oil & Gas,May,2005,Q2,May 2005,-33595895,51703,33647598
Oil & Gas,June,2005,Q2,June 2005,-20145248,946972,21092220
Oil & Gas,July,2005,Q3,July 2005,708754,14042587,13333833
Oil & Gas,August,2005,Q3,August 2005,-14383087,14750570,29133657
Oil & Gas,September,2005,Q3,September 2005,-37094438,153340,37247778
Oil & Gas,October,2005,Q4,October 2005,-90774496,4500,90778996
Oil & Gas,November,2005,Q4,November 2005,-64245442,11447301,75692743
Oil & Gas,December,2005,Q4,December 2005,-30838317,173660,31011977
Oil & Gas,January,2006,Q1,January 2006,-80778262,14965,80793227
Oil & Gas,February,2006,Q1,February 2006,-42499670,62585,42562255
Oil & Gas,March,2006,Q1,March 2006,-30701760,22419,30724179
Oil & Gas,April,2006,Q2,April 2006,-51872202,11553770,63425972
Oil & Gas,May,2006,Q2,May 2006,-13471226,81821,13553047
Oil & Gas,June,2006,Q2,June 2006,-20140787,40790,20181577
Oil & Gas,July,2006,Q3,July 2006,-23852180,,23852180
Oil & Gas,August,2006,Q3,August 2006,-28940764,12040,28952804
Oil & Gas,September,2006,Q3,September 2006,-125095453,14677,125110130
Oil & Gas,October,2006,Q4,October 2006,-44770298,16557,44786855
Oil & Gas,November,2006,Q4,November 2006,3744,3744,
Oil & Gas,December,2006,Q4,December 2006,2811,2811,
Oil & Gas,January,2007,Q1,January 2007,-11497817,14916,11512733
Oil & Gas,February,2007,Q1,February 2007,-14170596,,14170596
Oil & Gas,March,2007,Q1,March 2007,-24158493,14698,24173191
Oil & Gas,April,2007,Q2,April 2007,,,
Oil & Gas,May,2007,Q2,May 2007,-32992973,14079,33007052
Oil & Gas,June,2007,Q2,June 2007,-16068318,3290,16071608
Oil & Gas,July,2007,Q3,July 2007,-13292806,,13292806
Oil & Gas,August,2007,Q3,August 2007,13383,13383,
Oil & Gas,September,2007,Q3,September 2007,-13032263,,13032263
Oil & Gas,October,2007,Q4,October 2007,-16955306,17278,16972584
Oil & Gas,November,2007,Q4,November 2007,40001,40001,
Oil & Gas,December,2007,Q4,December 2007,-10080,2664,12744
Oil & Gas,January,2008,Q1,January 2008,-28007290,51826,28059116
Oil & Gas,February,2008,Q1,February 2008,-21340935,,21340935
Oil & Gas,March,2008,Q1,March 2008,-43667181,156889,43824070
Oil & Gas,April,2008,Q2,April 2008,-25202329,238653,25440982
Oil & Gas,May,2008,Q2,May 2008,-104055315,292975,104348290
Oil & Gas,June,2008,Q2,June 2008,-91360926,11236,91372162
Oil & Gas,July,2008,Q3,July 2008,-100438138,194112,100632250
Oil & Gas,August,2008,Q3,August 2008,-28868621,153170,29021791
Oil & Gas,September,2008,Q3,September 2008,-45896868,493739,46390607
Oil & Gas,October,2008,Q4,October 2008,508511,508511,
Oil & Gas,November,2008,Q4,November 2008,-9747447,52514,9799961
Oil & Gas,December,2008,Q4,December 2008,34932,34932,
Oil & Gas,January,2009,Q1,January 2009,-8358411,13459,8371870
Oil & Gas,February,2009,Q1,February 2009,47356,47356,
Oil & Gas,March,2009,Q1,March 2009,-8757592,21332,8778924
Oil & Gas,April,2009,Q2,April 2009,28163719,28178719,15000
Oil & Gas,May,2009,Q2,May 2009,-10911207,17585,10928792
Oil & Gas,June,2009,Q2,June 2009,135584,139334,3750
Oil & Gas,July,2009,Q3,July 2009,-16152087,25366,16177453
Oil & Gas,August,2009,Q3,August 2009,-16183465,70511,16253976
Oil & Gas,September,2009,Q3,September 2009,-15249267,152289,15401556
Oil & Gas,October,2009,Q4,October 2009,-15128,19100,34228
Oil & Gas,November,2009,Q4,November 2009,-17373103,172802,17545905
Oil & Gas,December,2009,Q4,December 2009,-17509278,7627,17516905
Oil & Gas,January,2010,Q1,January 2010,82549,82549,
Oil & Gas,February,2010,Q1,February 2010,-18499108,202532,18701640
Oil & Gas,March,2010,Q1,March 2010,-17244479,109665,17354144
Oil & Gas,April,2010,Q2,April 2010,14593740,14610847,17107
Oil & Gas,May,2010,Q2,May 2010,-19868283,406178,20274461
Oil & Gas,June,2010,Q2,June 2010,-16867910,620518,17488428
Oil & Gas,July,2010,Q3,July 2010,-15977975,780142,16758117
Oil & Gas,August,2010,Q3,August 2010,1066352,1066352,
Oil & Gas,September,2010,Q3,September 2010,1801547,1806750,5203
Oil & Gas,October,2010,Q4,October 2010,-15905876,1344428,17250304
Oil & Gas,November,2010,Q4,November 2010,1668409,1674001,5592
Oil & Gas,December,2010,Q4,December 2010,-17759231,1688310,19447541
Oil & Gas,January,2011,Q1,January 2011,-21269,59066,80335
Oil & Gas,February,2011,Q1,February 2011,278954,278954,
Oil & Gas,March,2011,Q1,March 2011,-34324445,1675317,35999762
Oil & Gas,April,2011,Q2,April 2011,3093414,3093414,
Oil & Gas,May,2011,Q2,May 2011,13020106,13022986,2880
Oil & Gas,June,2011,Q2,June 2011,383214,410043,26829
Oil & Gas,July,2011,Q3,July 2011,1279177,1399977,120800
Oil & Gas,August,2011,Q3,August 2011,1128302,1128302,
Oil & Gas,September,2011,Q3,September 2011,44679288,44698357,19069
Oil & Gas,October,2011,Q4,October 2011,-23477149,2325983,25803132
Oil & Gas,November,2011,Q4,November 2011,98810,98810,
Oil & Gas,December,2011,Q4,December 2011,356548,362548,6000
Oil & Gas,January,2012,Q1,January 2012,165188,165188,
Oil & Gas,February,2012,Q1,February 2012,31704835,31704835,
Oil & Gas,March,2012,Q1,March 2012,63881,30088914,30025033
Oil & Gas,April,2012,Q2,April 2012,627207,627207,
Oil & Gas,May,2012,Q2,May 2012,2009245,2027223,17978
Oil & Gas,June,2012,Q2,June 2012,-28717336,602472,29319808
Oil & Gas,July,2012,Q3,July 2012,9320577,9320577,
Oil & Gas,August,2012,Q3,August 2012,-21187938,674115,21862053
Oil & Gas,September,2012,Q3,September 2012,40614,40614,
Oil & Gas,October,2012,Q4,October 2012,1621277,1621277,
Oil & Gas,November,2012,Q4,November 2012,377373,377373,
Oil & Gas,December,2012,Q4,December 2012,2544192,2544192,
Oil & Gas,January,2013,Q1,January 2013,27330804,27340284,9480
Oil & Gas,February,2013,Q1,February 2013,1299296,1299296,
Oil & Gas,March,2013,Q1,March 2013,-26792198,451163,27243361
Oil & Gas,April,2013,Q2,April 2013,1901311,1901311,
Oil & Gas,May,2013,Q2,May 2013,-23232783,1481173,24713956
Oil & Gas,June,2013,Q2,June 2013,576188,578708,2520
Oil & Gas,July,2013,Q3,July 2013,91440,100920,9480
Oil & Gas,August,2013,Q3,August 2013,-30013,3731,33744
Oil & Gas,September,2013,Q3,September 2013,225541,277363,51822
Oil & Gas,October,2013,Q4,October 2013,49559506,49566706,7200
Oil & Gas,November,2013,Q4,November 2013,20923671,20923671,
Oil & Gas,December,2013,Q4,December 2013,70212523,70212523,
Oil & Gas,January,2014,Q1,January 2014,,,
Oil & Gas,February,2014,Q1,February 2014,40933105,40965000,31895
Oil & Gas,March,2014,Q1,March 2014,30215694,30227109,11415
Oil & Gas,April,2014,Q2,April 2014,27125304,27142954,17650
Oil & Gas,May,2014,Q2,May 2014,58496826,58556649,59823
Oil & Gas,June,2014,Q2,June 2014,22246894,22301946,55052
Oil & Gas,July,2014,Q3,July 2014,11120,16500,5380
Oil & Gas,August,2014,Q3,August 2014,-130278,3850,134128
Oil & Gas,September,2014,Q3,September 2014,27962968,27987057,24089
Oil & Gas,October,2014,Q4,October 2014,29402003,29472113,70110
Oil & Gas,November,2014,Q4,November 2014,43919101,43928641,9540
Oil & Gas,December,2014,Q4,December 2014,79464992,79595732,130740
Oil & Gas,January,2015,Q1,January 2015,24380516,24455704,75188
Oil & Gas,February,2015,Q1,February 2015,87279033,87457932,178899
Oil & Gas,March,2015,Q1,March 2015,64243054,64321103,78049
Oil & Gas,April,2015,Q2,April 2015,79105825,79225270,119445
Oil & Gas,May,2015,Q2,May 2015,73637910,73746775,108865
Oil & Gas,June,2015,Q2,June 2015,64329431,64423462,94031
Oil & Gas,July,2015,Q3,July 2015,87979868,88100727,120859
Oil & Gas,August,2015,Q3,August 2015,113153628,113153628,
Oil & Gas,September,2015,Q3,September 2015,106799605,106930454,130849
Oil & Gas,October,2015,Q4,October 2015,82849544,82880792,31248
Oil & Gas,November,2015,Q4,November 2015,111645091,111754670,109579
Oil & Gas,December,2015,Q4,December 2015,81350002,81402941,52939
Oil & Gas,January,2016,Q1,January 2016,103102955,103166914,63959
Oil & Gas,February,2016,Q1,February 2016,126590743,126637744,47001
Oil & Gas,March,2016,Q1,March 2016,97864354,97870354,6000
Oil & Gas,April,2016,Q2,April 2016,83709749,83948418,238669
Oil & Gas,May,2016,Q2,May 2016,88886631,89022971,136340
Oil & Gas,June,2016,Q2,June 2016,39356581,39402146,45565
Oil & Gas,July,2016,Q3,July 2016,135987906,136047760,59854
Oil & Gas,August,2016,Q3,August 2016,57614504,57671071,56567
Oil & Gas,September,2016,Q3,September 2016,29473840,29577881,104041
Oil & Gas,October,2016,Q4,October 2016,172705578,172754569,48991
Oil & Gas,November,2016,Q4,November 2016,230639403,230769064,129661
Oil & Gas,December,2016,Q4,December 2016,258257251,258404692,147441
Oil & Gas,January,2017,Q1,January 2017,287504935,287644615,139680
Oil & Gas,February,2017,Q1,February 2017,709612463,709697214,84751
Oil & Gas,March,2017,Q1,March 2017,405381480,405538557,157077
Oil & Gas,April,2017,Q2,April 2017,534745682,534866846,121164
Oil & Gas,May,2017,Q2,May 2017,410644410,410968092,323682
Oil & Gas,June,2017,Q2,June 2017,285825273,285936719,111446
Oil & Gas,July,2017,Q3,July 2017,236453210,236601933,148723
Oil & Gas,August,2017,Q3,August 2017,407188141,407237048,48907
Oil & Gas,September,2017,Q3,September 2017,713008615,713033410,24795
Oil & Gas,October,2017,Q4,October 2017,1160565399,1160576139,10740
Oil & Gas,November,2017,Q4,November 2017,762255498,762397744,142246
Oil & Gas,December,2017,Q4,December 2017,815905017,815989062,84045
Oil & Gas,January,2018,Q1,January 2018,925168301,925291759,123458
Oil & Gas,February,2018,Q1,February 2018,794914741,795064852,150111
Oil & Gas,March,2018,Q1,March 2018,1141755175,1141755175,
Oil & Gas,April,2018,Q2,April 2018,879867323,880066385,199062
Oil & Gas,May,2018,Q2,May 2018,771235931,771318134,82203
Oil & Gas,June,2018,Q2,June 2018,946397221,946630181,232960
Oil & Gas,July,2018,Q3,July 2018,993377703,993588295,210592
Oil & Gas,August,2018,Q3,August 2018,144196903,144355672,158769
Oil & Gas,September,2018,Q3,September 2018,31454895,31512049,57154
Oil & Gas,October,2018,Q4,October 2018,86505942,86605083,99141
Oil & Gas,November,2018,Q4,November 2018,102197233,102287664,90431
Oil & Gas,December,2018,Q4,December 2018,241343602,241480509,136907
Oil & Gas,January,2019,Q1,January 2019,78193961,78324279,130318
Oil & Gas,February,2019,Q1,February 2019,262676829,262739749,62920
Oil & Gas,March,2019,Q1,March 2019,126516101,126567084,50983
Oil & Gas,April,2019,Q2,April 2019,115318366,115358488,40122
Oil & Gas,May,2019,Q2,May 2019,540670469,540744750,74281
Oil & Gas,June,2019,Q2,June 2019,579570963,579632805,61842
Oil & Gas,July,2019,Q3,July 2019,419672279,419739144,66865
Oil & Gas,August,2019,Q3,August 2019,409600056,409637721,37665
Oil & Gas,September,2019,Q3,September 2019,423660886,423795240,134354
Oil & Gas,October,2019,Q4,October 2019,-15766,67704,83470
Oil & Gas,November,2019,Q4,November 2019,130163663,130163663,
Oil & Gas,December,2019,Q4,December 2019,32158326,32225518,67192
Minerals & Ores,January,2002,Q1,January 2002,-10091247,4628172,14719419
Minerals & Ores,February,2002,Q1,February 2002,-2452675,4961496,7414171
Minerals & Ores,March,2002,Q1,March 2002,-8555916,4521328,13077244
Minerals & Ores,April,2002,Q2,April 2002,-1964768,5149588,7114356
Minerals & Ores,May,2002,Q2,May 2002,-4306254,4717850,9024104
Minerals & Ores,June,2002,Q2,June 2002,1072987,7370871,6297884
Minerals & Ores,July,2002,Q3,July 2002,-5833130,6890429,12723559
Minerals & Ores,August,2002,Q3,August 2002,-142235,6599376,6741611
Minerals & Ores,September,2002,Q3,September 2002,-5709948,5039536,10749484
Minerals & Ores,October,2002,Q4,October 2002,-11723430,7561708,19285138
Minerals & Ores,November,2002,Q4,November 2002,-4536664,6920572,11457236
Minerals & Ores,December,2002,Q4,December 2002,-2234168,7052663,9286831
Minerals & Ores,January,2003,Q1,January 2003,-7377105,7980797,15357902
Minerals & Ores,February,2003,Q1,February 2003,1855660,5187626,3331966
Minerals & Ores,March,2003,Q1,March 2003,-8873142,3459030,12332172
Minerals & Ores,April,2003,Q2,April 2003,-4950330,6343486,11293816
Minerals & Ores,May,2003,Q2,May 2003,-1549014,11609345,13158359
Minerals & Ores,June,2003,Q2,June 2003,-655306,8903726,9559032
Minerals & Ores,July,2003,Q3,July 2003,-14542614,6092392,20635006
Minerals & Ores,August,2003,Q3,August 2003,6665678,16211394,9545716
Minerals & Ores,September,2003,Q3,September 2003,2965608,16739791,13774183
Minerals & Ores,October,2003,Q4,October 2003,-3778638,8093620,11872258
Minerals & Ores,November,2003,Q4,November 2003,4331736,13239870,8908134
Minerals & Ores,December,2003,Q4,December 2003,3519182,15389925,11870743
Minerals & Ores,January,2004,Q1,January 2004,-15091031,9111398,24202429
Minerals & Ores,February,2004,Q1,February 2004,-4122707,14989973,19112680
Minerals & Ores,March,2004,Q1,March 2004,9637876,20581208,10943332
Minerals & Ores,April,2004,Q2,April 2004,-580502,10393589,10974091
Minerals & Ores,May,2004,Q2,May 2004,8606694,22140561,13533867
Minerals & Ores,June,2004,Q2,June 2004,-6822143,10183818,17005961
Minerals & Ores,July,2004,Q3,July 2004,90163,16436925,16346762
Minerals & Ores,August,2004,Q3,August 2004,23561919,46019546,22457627
Minerals & Ores,September,2004,Q3,September 2004,-991162,17829271,18820433
Minerals & Ores,October,2004,Q4,October 2004,7742220,19425731,11683511
Minerals & Ores,November,2004,Q4,November 2004,5373049,13979089,8606040
Minerals & Ores,December,2004,Q4,December 2004,17910505,29999574,12089069
Minerals & Ores,January,2005,Q1,January 2005,-12313121,21443705,33756826
Minerals & Ores,February,2005,Q1,February 2005,12994418,24766865,11772447
Minerals & Ores,March,2005,Q1,March 2005,-1730449,18608870,20339319
Minerals & Ores,April,2005,Q2,April 2005,41117533,60031562,18914029
Minerals & Ores,May,2005,Q2,May 2005,17287979,36042037,18754058
Minerals & Ores,June,2005,Q2,June 2005,35152495,49142151,13989656
Minerals & Ores,July,2005,Q3,July 2005,46201987,60009498,13807511
Minerals & Ores,August,2005,Q3,August 2005,26332010,48075630,21743620
Minerals & Ores,September,2005,Q3,September 2005,43007373,73880662,30873289
Minerals & Ores,October,2005,Q4,October 2005,28800488,43145515,14345027
Minerals & Ores,November,2005,Q4,November 2005,4305499,28158963,23853464
Minerals & Ores,December,2005,Q4,December 2005,17659717,32208965,14549248
Minerals & Ores,January,2006,Q1,January 2006,-8007767,24778146,32785913
Minerals & Ores,February,2006,Q1,February 2006,11262910,28565779,17302869
Minerals & Ores,March,2006,Q1,March 2006,25947386,47715422,21768036
Minerals & Ores,April,2006,Q2,April 2006,6117579,27710287,21592708
Minerals & Ores,May,2006,Q2,May 2006,27025711,46393723,19368012
Minerals & Ores,June,2006,Q2,June 2006,-8210568,14865568,23076136
Minerals & Ores,July,2006,Q3,July 2006,-3913969,30070463,33984432
Minerals & Ores,August,2006,Q3,August 2006,22633424,40878069,18244645
Minerals & Ores,September,2006,Q3,September 2006,20392046,37519321,17127275
Minerals & Ores,October,2006,Q4,October 2006,63424667,82359426,18934759
Minerals & Ores,November,2006,Q4,November 2006,42626090,67787967,25161877
Minerals & Ores,December,2006,Q4,December 2006,38607278,63657252,25049974
Minerals & Ores,January,2007,Q1,January 2007,5598662,35062473,29463811
Minerals & Ores,February,2007,Q1,February 2007,7663022,27643872,19980850
Minerals & Ores,March,2007,Q1,March 2007,42531545,60603947,18072402
Minerals & Ores,April,2007,Q2,April 2007,13384409,40033545,26649136
Minerals & Ores,May,2007,Q2,May 2007,35857583,62405742,26548159
Minerals & Ores,June,2007,Q2,June 2007,74940047,100181410,25241363
Minerals & Ores,July,2007,Q3,July 2007,109701810,120285689,10583879
Minerals & Ores,August,2007,Q3,August 2007,185280389,207451393,22171004
Minerals & Ores,September,2007,Q3,September 2007,65098772,87181374,22082602
Minerals & Ores,October,2007,Q4,October 2007,29904540,47472235,17567695
Minerals & Ores,November,2007,Q4,November 2007,59958937,91543248,31584311
Minerals & Ores,December,2007,Q4,December 2007,54676228,75410354,20734126
Minerals & Ores,January,2008,Q1,January 2008,-362166,14552309,14914475
Minerals & Ores,February,2008,Q1,February 2008,78455746,99115139,20659393
Minerals & Ores,March,2008,Q1,March 2008,10558605,35594221,25035616
Minerals & Ores,April,2008,Q2,April 2008,54572480,82289113,27716633
Minerals & Ores,May,2008,Q2,May 2008,38151668,62498529,24346861
Minerals & Ores,June,2008,Q2,June 2008,6710306,35355329,28645023
Minerals & Ores,July,2008,Q3,July 2008,134381183,141214448,6833265
Minerals & Ores,August,2008,Q3,August 2008,60315203,93964296,33649093
Minerals & Ores,September,2008,Q3,September 2008,69454560,110065073,40610513
Minerals & Ores,October,2008,Q4,October 2008,32589445,52600884,20011439
Minerals & Ores,November,2008,Q4,November 2008,12181579,70033925,57852346
Minerals & Ores,December,2008,Q4,December 2008,41809136,57486872,15677736
Minerals & Ores,January,2009,Q1,January 2009,-8641842,39816196,48458038
Minerals & Ores,February,2009,Q1,February 2009,16060212,26452856,10392644
Minerals & Ores,March,2009,Q1,March 2009,55010398,62227700,7217302
Minerals & Ores,April,2009,Q2,April 2009,54435352,64320992,9885640
Minerals & Ores,May,2009,Q2,May 2009,44260218,52718126,8457908
Minerals & Ores,June,2009,Q2,June 2009,48504040,58921218,10417178
Minerals & Ores,July,2009,Q3,July 2009,64795128,76354662,11559534
Minerals & Ores,August,2009,Q3,August 2009,80110264,89664739,9554475
Minerals & Ores,September,2009,Q3,September 2009,141620008,145577281,3957273
Minerals & Ores,October,2009,Q4,October 2009,94533352,102179484,7646132
Minerals & Ores,November,2009,Q4,November 2009,85842899,96184963,10342064
Minerals & Ores,December,2009,Q4,December 2009,95699385,100163913,4464528
Minerals & Ores,January,2010,Q1,January 2010,75183144,89439239,14256095
Minerals & Ores,February,2010,Q1,February 2010,129269266,138013085,8743819
Minerals & Ores,March,2010,Q1,March 2010,127895512,150937651,23042139
Minerals & Ores,April,2010,Q2,April 2010,170329445,171788804,1459359
Minerals & Ores,May,2010,Q2,May 2010,91004576,106294826,15290250
Minerals & Ores,June,2010,Q2,June 2010,111530715,141029719,29499004
Minerals & Ores,July,2010,Q3,July 2010,194706698,210148387,15441689
Minerals & Ores,August,2010,Q3,August 2010,167068983,184931375,17862392
Minerals & Ores,September,2010,Q3,September 2010,243822010,254347149,10525139
Minerals & Ores,October,2010,Q4,October 2010,161572339,174025874,12453535
Minerals & Ores,November,2010,Q4,November 2010,171366291,199016212,27649921
Minerals & Ores,December,2010,Q4,December 2010,225737820,237210222,11472402
Minerals & Ores,January,2011,Q1,January 2011,179358213,191509284,12151071
Minerals & Ores,February,2011,Q1,February 2011,185486842,197389249,11902407
Minerals & Ores,March,2011,Q1,March 2011,252950620,271513328,18562708
Minerals & Ores,April,2011,Q2,April 2011,209972343,220732649,10760306
Minerals & Ores,May,2011,Q2,May 2011,136887475,157849552,20962077
Minerals & Ores,June,2011,Q2,June 2011,200218728,209276184,9057456
Minerals & Ores,July,2011,Q3,July 2011,93075152,107854167,14779015
Minerals & Ores,August,2011,Q3,August 2011,229115382,249521322,20405940
Minerals & Ores,September,2011,Q3,September 2011,236029369,271613212,35583843
Minerals & Ores,October,2011,Q4,October 2011,204233770,246726557,42492787
Minerals & Ores,November,2011,Q4,November 2011,274154055,284130476,9976421
Minerals & Ores,December,2011,Q4,December 2011,219041959,245849216,26807257
Minerals & Ores,January,2012,Q1,January 2012,111248748,143694820,32446072
Minerals & Ores,February,2012,Q1,February 2012,162107735,192992373,30884638
Minerals & Ores,March,2012,Q1,March 2012,215569686,237698512,22128826
Minerals & Ores,April,2012,Q2,April 2012,296613670,313153999,16540329
Minerals & Ores,May,2012,Q2,May 2012,407356046,420005648,12649602
Minerals & Ores,June,2012,Q2,June 2012,425467893,428987291,3519398
Minerals & Ores,July,2012,Q3,July 2012,216448957,233001733,16552776
Minerals & Ores,August,2012,Q3,August 2012,125254098,146858592,21604494
Minerals & Ores,September,2012,Q3,September 2012,178062585,195191614,17129029
Minerals & Ores,October,2012,Q4,October 2012,282395562,314077592,31682030
Minerals & Ores,November,2012,Q4,November 2012,188479698,235317289,46837591
Minerals & Ores,December,2012,Q4,December 2012,187249119,208061570,20812451
Minerals & Ores,January,2013,Q1,January 2013,196567904,215728450,19160546
Minerals & Ores,February,2013,Q1,February 2013,187730107,200956099,13225992
Minerals & Ores,March,2013,Q1,March 2013,301820250,310235619,8415369
Minerals & Ores,April,2013,Q2,April 2013,298283896,305630525,7346629
Minerals & Ores,May,2013,Q2,May 2013,150205668,175069149,24863481
Minerals & Ores,June,2013,Q2,June 2013,136181477,147032116,10850639
Minerals & Ores,July,2013,Q3,July 2013,81953704,105885594,23931890
Minerals & Ores,August,2013,Q3,August 2013,142218371,156683586,14465215
Minerals & Ores,September,2013,Q3,September 2013,250008055,274820245,24812190
Minerals & Ores,October,2013,Q4,October 2013,250089907,279787330,29697423
Minerals & Ores,November,2013,Q4,November 2013,150318618,164863123,14544505
Minerals & Ores,December,2013,Q4,December 2013,191384422,207285179,15900757
Minerals & Ores,January,2014,Q1,January 2014,122124923,132995862,10870939
Minerals & Ores,February,2014,Q1,February 2014,175419435,186860504,11441069
Minerals & Ores,March,2014,Q1,March 2014,172569010,202750407,30181397
Minerals & Ores,April,2014,Q2,April 2014,82202408,105140165,22937757
Minerals & Ores,May,2014,Q2,May 2014,91590413,126024757,34434344
Minerals & Ores,June,2014,Q2,June 2014,152566053,178205124,25639071
Minerals & Ores,July,2014,Q3,July 2014,172203486,192532231,20328745
Minerals & Ores,August,2014,Q3,August 2014,108303396,124453773,16150377
Minerals & Ores,September,2014,Q3,September 2014,146529106,159201450,12672344
Minerals & Ores,October,2014,Q4,October 2014,165837388,189936055,24098667
Minerals & Ores,November,2014,Q4,November 2014,70787407,92833262,22045855
Minerals & Ores,December,2014,Q4,December 2014,123444279,135907047,12462768
Minerals & Ores,January,2015,Q1,January 2015,19971109,68265871,48294762
Minerals & Ores,February,2015,Q1,February 2015,70337719,100266859,29929140
Minerals & Ores,March,2015,Q1,March 2015,74669972,92789255,18119283
Minerals & Ores,April,2015,Q2,April 2015,80635219,89554121,8918902
Minerals & Ores,May,2015,Q2,May 2015,56652220,75054346,18402126
Minerals & Ores,June,2015,Q2,June 2015,64004285,84736975,20732690
Minerals & Ores,July,2015,Q3,July 2015,69729483,86118516,16389033
Minerals & Ores,August,2015,Q3,August 2015,106148454,130179068,24030614
Minerals & Ores,September,2015,Q3,September 2015,202146751,214354371,12207620
Minerals & Ores,October,2015,Q4,October 2015,65033982,96468509,31434527
Minerals & Ores,November,2015,Q4,November 2015,85548587,93820354,8271767
Minerals & Ores,December,2015,Q4,December 2015,43455786,55286039,11830253
Minerals & Ores,January,2016,Q1,January 2016,57849328,73234127,15384799
Minerals & Ores,February,2016,Q1,February 2016,40586197,68432303,27846106
Minerals & Ores,March,2016,Q1,March 2016,71973046,86454256,14481210
Minerals & Ores,April,2016,Q2,April 2016,55996856,65128949,9132093
Minerals & Ores,May,2016,Q2,May 2016,50452094,64250088,13797994
Minerals & Ores,June,2016,Q2,June 2016,52884469,75343234,22458765
Minerals & Ores,July,2016,Q3,July 2016,75261627,93762464,18500837
Minerals & Ores,August,2016,Q3,August 2016,108248069,121022245,12774176
Minerals & Ores,September,2016,Q3,September 2016,84459286,97852466,13393180
Minerals & Ores,October,2016,Q4,October 2016,177367260,187189281,9822021
Minerals & Ores,November,2016,Q4,November 2016,183340954,189432122,6091168
Minerals & Ores,December,2016,Q4,December 2016,130566602,148221940,17655338
Minerals & Ores,January,2017,Q1,January 2017,117722032,130739700,13017668
Minerals & Ores,February,2017,Q1,February 2017,59268836,72234756,12965920
Minerals & Ores,March,2017,Q1,March 2017,107499827,125335586,17835759
Minerals & Ores,April,2017,Q2,April 2017,125937687,138884793,12947106
Minerals & Ores,May,2017,Q2,May 2017,111772993,129757622,17984629
Minerals & Ores,June,2017,Q2,June 2017,101157222,123043513,21886291
Minerals & Ores,July,2017,Q3,July 2017,161631067,188513379,26882312
Minerals & Ores,August,2017,Q3,August 2017,169251111,188987043,19735932
Minerals & Ores,September,2017,Q3,September 2017,172341406,190929741,18588335
Minerals & Ores,October,2017,Q4,October 2017,149552616,177967524,28414908
Minerals & Ores,November,2017,Q4,November 2017,126063964,142230393,16166429
Minerals & Ores,December,2017,Q4,December 2017,123539146,149023868,25484722
Minerals & Ores,January,2018,Q1,January 2018,122846896,138407426,15560530
Minerals & Ores,February,2018,Q1,February 2018,120283079,139217642,18934563
Minerals & Ores,March,2018,Q1,March 2018,145706962,165554922,19847960
Minerals & Ores,April,2018,Q2,April 2018,118537080,126009408,7472328
Minerals & Ores,May,2018,Q2,May 2018,100068762,123920026,23851264
Minerals & Ores,June,2018,Q2,June 2018,157585669,185412719,27827050
Minerals & Ores,July,2018,Q3,July 2018,155044441,175518887,20474446
Minerals & Ores,August,2018,Q3,August 2018,90229935,105705264,15475329
Minerals & Ores,September,2018,Q3,September 2018,12219795,42422953,30203158
Minerals & Ores,October,2018,Q4,October 2018,59268106,80792223,21524117
Minerals & Ores,November,2018,Q4,November 2018,16033957,28796406,12762449
Minerals & Ores,December,2018,Q4,December 2018,42954775,54165899,11211124
Minerals & Ores,January,2019,Q1,January 2019,37367079,46909017,9541938
Minerals & Ores,February,2019,Q1,February 2019,32307108,49346089,17038981
Minerals & Ores,March,2019,Q1,March 2019,20946671,31644613,10697942
Minerals & Ores,April,2019,Q2,April 2019,38769850,46395419,7625569
Minerals & Ores,May,2019,Q2,May 2019,23841252,44703573,20862321
Minerals & Ores,June,2019,Q2,June 2019,40312312,63974212,23661900
Minerals & Ores,July,2019,Q3,July 2019,30034869,43416353,13381484
Minerals & Ores,August,2019,Q3,August 2019,23763865,45887181,22123316
Minerals & Ores,September,2019,Q3,September 2019,55144901,68527456,13382555
Minerals & Ores,October,2019,Q4,October 2019,42967364,57546145,14578781
Minerals & Ores,November,2019,Q4,November 2019,45598612,57567201,11968589
Minerals & Ores,December,2019,Q4,December 2019,-1636461,19837067,21473528
Food & Kindred Products,January,2002,Q1,January 2002,-11624773,48217713,59842486
Food & Kindred Products,February,2002,Q1,February 2002,8953729,64788369,55834640
Food & Kindred Products,March,2002,Q1,March 2002,2585444,60279053,57693609
Food & Kindred Products,April,2002,Q2,April 2002,-805202,57241436,58046638
Food & Kindred Products,May,2002,Q2,May 2002,13087597,72364876,59277279
Food & Kindred Products,June,2002,Q2,June 2002,10346477,72091329,61744852
Food & Kindred Products,July,2002,Q3,July 2002,-2943638,62705215,65648853
Food & Kindred Products,August,2002,Q3,August 2002,5659362,74913700,69254338
Food & Kindred Products,September,2002,Q3,September 2002,15435752,75258736,59822984
Food & Kindred Products,October,2002,Q4,October 2002,6457655,63359646,56901991
Food & Kindred Products,November,2002,Q4,November 2002,25202722,84852459,59649737
Food & Kindred Products,December,2002,Q4,December 2002,-18223979,65524179,83748158
Food & Kindred Products,January,2003,Q1,January 2003,-24037635,58499424,82537059
Food & Kindred Products,February,2003,Q1,February 2003,20722026,87152909,66430883
Food & Kindred Products,March,2003,Q1,March 2003,20118499,100928920,80810421
Food & Kindred Products,April,2003,Q2,April 2003,4097399,87583667,83486268
Food & Kindred Products,May,2003,Q2,May 2003,-5365887,87312330,92678217
Food & Kindred Products,June,2003,Q2,June 2003,12643502,90155534,77512032
Food & Kindred Products,July,2003,Q3,July 2003,32509472,120255155,87745683
Food & Kindred Products,August,2003,Q3,August 2003,30296592,107556878,77260286
Food & Kindred Products,September,2003,Q3,September 2003,6344977,88135919,81790942
Food & Kindred Products,October,2003,Q4,October 2003,9011609,100867632,91856023
Food & Kindred Products,November,2003,Q4,November 2003,11111327,102650575,91539248
Food & Kindred Products,December,2003,Q4,December 2003,-6068459,94398271,100466730
Food & Kindred Products,January,2004,Q1,January 2004,-34062742,73880707,107943449
Food & Kindred Products,February,2004,Q1,February 2004,-19721171,70697474,90418645
Food & Kindred Products,March,2004,Q1,March 2004,833376,102064953,101231577
Food & Kindred Products,April,2004,Q2,April 2004,-36927660,93814518,130742178
Food & Kindred Products,May,2004,Q2,May 2004,-9290401,115706144,124996545
Food & Kindred Products,June,2004,Q2,June 2004,3871515,113928097,110056582
Food & Kindred Products,July,2004,Q3,July 2004,-16559,101053591,101070150
Food & Kindred Products,August,2004,Q3,August 2004,8369177,96608906,88239729
Food & Kindred Products,September,2004,Q3,September 2004,-3740708,84791574,88532282
Food & Kindred Products,October,2004,Q4,October 2004,-13043430,86423945,99467375
Food & Kindred Products,November,2004,Q4,November 2004,-34574875,72129617,106704492
Food & Kindred Products,December,2004,Q4,December 2004,-49127477,77212583,126340060
Food & Kindred Products,January,2005,Q1,January 2005,-69242670,69641591,138884261
Food & Kindred Products,February,2005,Q1,February 2005,-23797957,87426924,111224881
Food & Kindred Products,March,2005,Q1,March 2005,-23806853,88809218,112616071
Food & Kindred Products,April,2005,Q2,April 2005,-14768998,101782867,116551865
Food & Kindred Products,May,2005,Q2,May 2005,-32282934,109137037,141419971
Food & Kindred Products,June,2005,Q2,June 2005,-43399728,94029686,137429414
Food & Kindred Products,July,2005,Q3,July 2005,-24588284,102921079,127509363
Food & Kindred Products,August,2005,Q3,August 2005,-12256484,117874235,130130719
Food & Kindred Products,September,2005,Q3,September 2005,-11822740,105560925,117383665
Food & Kindred Products,October,2005,Q4,October 2005,-22196335,104005242,126201577
Food & Kindred Products,November,2005,Q4,November 2005,-5138316,118069875,123208191
Food & Kindred Products,December,2005,Q4,December 2005,-34968629,108688997,143657626
Food & Kindred Products,January,2006,Q1,January 2006,-52370072,97855126,150225198
Food & Kindred Products,February,2006,Q1,February 2006,-31303084,104013097,135316181
Food & Kindred Products,March,2006,Q1,March 2006,11229027,143862322,132633295
Food & Kindred Products,April,2006,Q2,April 2006,-19838569,130333192,150171761
Food & Kindred Products,May,2006,Q2,May 2006,-4268407,152210412,156478819
Food & Kindred Products,June,2006,Q2,June 2006,-21943413,137514219,159457632
Food & Kindred Products,July,2006,Q3,July 2006,-365837,148917237,149283074
Food & Kindred Products,August,2006,Q3,August 2006,453536,162777168,162323632
Food & Kindred Products,September,2006,Q3,September 2006,-2312220,134908828,137221048
Food & Kindred Products,October,2006,Q4,October 2006,-20459304,147991541,168450845
Food & Kindred Products,November,2006,Q4,November 2006,-46137615,148265754,194403369
Food & Kindred Products,December,2006,Q4,December 2006,1965490,195506664,193541174
Food & Kindred Products,January,2007,Q1,January 2007,-40692097,173899163,214591260
Food & Kindred Products,February,2007,Q1,February 2007,-33324368,169884143,203208511
Food & Kindred Products,March,2007,Q1,March 2007,-26026644,162476190,188502834
Food & Kindred Products,April,2007,Q2,April 2007,-44268260,153590318,197858578
Food & Kindred Products,May,2007,Q2,May 2007,-22307772,184347876,206655648
Food & Kindred Products,June,2007,Q2,June 2007,-12655418,192842174,205497592
Food & Kindred Products,July,2007,Q3,July 2007,-26194591,191943075,218137666
Food & Kindred Products,August,2007,Q3,August 2007,11580510,222924080,211343570
Food & Kindred Products,September,2007,Q3,September 2007,19443403,212077972,192634569
Food & Kindred Products,October,2007,Q4,October 2007,24059757,211711241,187651484
Food & Kindred Products,November,2007,Q4,November 2007,-31390783,192672476,224063259
Food & Kindred Products,December,2007,Q4,December 2007,8537535,248684610,240147075
Food & Kindred Products,January,2008,Q1,January 2008,-92968425,198777394,291745819
Food & Kindred Products,February,2008,Q1,February 2008,22910982,276552928,253641946
Food & Kindred Products,March,2008,Q1,March 2008,42492478,245046705,202554227
Food & Kindred Products,April,2008,Q2,April 2008,37416610,271871910,234455300
Food & Kindred Products,May,2008,Q2,May 2008,-20899216,253790008,274689224
Food & Kindred Products,June,2008,Q2,June 2008,-15798998,248222319,264021317
Food & Kindred Products,July,2008,Q3,July 2008,-53824677,222313730,276138407
Food & Kindred Products,August,2008,Q3,August 2008,-69565433,198198802,267764235
Food & Kindred Products,September,2008,Q3,September 2008,-39975554,198813370,238788924
Food & Kindred Products,October,2008,Q4,October 2008,-47520899,204541824,252062723
Food & Kindred Products,November,2008,Q4,November 2008,-37082032,186059610,223141642
Food & Kindred Products,December,2008,Q4,December 2008,-93642168,128355580,221997748
Food & Kindred Products,January,2009,Q1,January 2009,-94525409,134839339,229364748
Food & Kindred Products,February,2009,Q1,February 2009,-38554356,137684510,176238866
Food & Kindred Products,March,2009,Q1,March 2009,3220967,186098029,182877062
Food & Kindred Products,April,2009,Q2,April 2009,8961335,215581992,206620657
Food & Kindred Products,May,2009,Q2,May 2009,-41275419,172992574,214267993
Food & Kindred Products,June,2009,Q2,June 2009,-61535993,155048780,216584773
Food & Kindred Products,July,2009,Q3,July 2009,-58418449,172133855,230552304
Food & Kindred Products,August,2009,Q3,August 2009,-15171807,186641005,201812812
Food & Kindred Products,September,2009,Q3,September 2009,-16581829,193514049,210095878
Food & Kindred Products,October,2009,Q4,October 2009,-11260192,190589856,201850048
Food & Kindred Products,November,2009,Q4,November 2009,-7333978,185502318,192836296
Food & Kindred Products,December,2009,Q4,December 2009,-17316304,202451041,219767345
Food & Kindred Products,January,2010,Q1,January 2010,-63333140,154691510,218024650
Food & Kindred Products,February,2010,Q1,February 2010,-22468214,162646432,185114646
Food & Kindred Products,March,2010,Q1,March 2010,-15823000,176752289,192575289
Food & Kindred Products,April,2010,Q2,April 2010,-5783071,194575179,200358250
Food & Kindred Products,May,2010,Q2,May 2010,-41399792,198714261,240114053
Food & Kindred Products,June,2010,Q2,June 2010,-70579220,196141404,266720624
Food & Kindred Products,July,2010,Q3,July 2010,-33385923,238368724,271754647
Food & Kindred Products,August,2010,Q3,August 2010,-7168358,269356742,276525100
Food & Kindred Products,September,2010,Q3,September 2010,11710207,249471224,237761017
Food & Kindred Products,October,2010,Q4,October 2010,44848392,291192192,246343800
Food & Kindred Products,November,2010,Q4,November 2010,77197304,309517191,232319887
Food & Kindred Products,December,2010,Q4,December 2010,114941141,401386531,286445390
Food & Kindred Products,January,2011,Q1,January 2011,-59119524,248305105,307424629
Food & Kindred Products,February,2011,Q1,February 2011,-48730026,213625044,262355070
Food & Kindred Products,March,2011,Q1,March 2011,40462435,282612159,242149724
Food & Kindred Products,April,2011,Q2,April 2011,-96137865,204120495,300258360
Food & Kindred Products,May,2011,Q2,May 2011,-97539144,223182217,320721361
Food & Kindred Products,June,2011,Q2,June 2011,-69209809,234651712,303861521
Food & Kindred Products,July,2011,Q3,July 2011,30149278,305446133,275296855
Food & Kindred Products,August,2011,Q3,August 2011,3215465,302012609,298797144
Food & Kindred Products,September,2011,Q3,September 2011,106381456,358761804,252380348
Food & Kindred Products,October,2011,Q4,October 2011,122655927,358354005,235698078
Food & Kindred Products,November,2011,Q4,November 2011,89699469,362006896,272307427
Food & Kindred Products,December,2011,Q4,December 2011,-14388400,318174174,332562574
Food & Kindred Products,January,2012,Q1,January 2012,-83966577,282021751,365988328
Food & Kindred Products,February,2012,Q1,February 2012,-22304553,263032291,285336844
Food & Kindred Products,March,2012,Q1,March 2012,38843360,295583219,256739859
Food & Kindred Products,April,2012,Q2,April 2012,-16533804,300331396,316865200
Food & Kindred Products,May,2012,Q2,May 2012,-24730062,305537058,330267120
Food & Kindred Products,June,2012,Q2,June 2012,-47367478,308608597,355976075
Food & Kindred Products,July,2012,Q3,July 2012,60767807,412949548,352181741
Food & Kindred Products,August,2012,Q3,August 2012,70498177,392363436,321865259
Food & Kindred Products,September,2012,Q3,September 2012,10010205,309566929,299556724
Food & Kindred Products,October,2012,Q4,October 2012,139421257,433735364,294314107
Food & Kindred Products,November,2012,Q4,November 2012,66848110,382872297,316024187
Food & Kindred Products,December,2012,Q4,December 2012,24650558,373760518,349109960
Food & Kindred Products,January,2013,Q1,January 2013,-50700008,333797698,384497706
Food & Kindred Products,February,2013,Q1,February 2013,113490976,382470717,268979741
Food & Kindred Products,March,2013,Q1,March 2013,96093388,323283215,227189827
Food & Kindred Products,April,2013,Q2,April 2013,100238560,387378032,287139472
Food & Kindred Products,May,2013,Q2,May 2013,45732908,373220626,327487718
Food & Kindred Products,June,2013,Q2,June 2013,86699928,399360374,312660446
Food & Kindred Products,July,2013,Q3,July 2013,77822369,401881619,324059250
Food & Kindred Products,August,2013,Q3,August 2013,110969608,424594751,313625143
Food & Kindred Products,September,2013,Q3,September 2013,96551247,397381821,300830574
Food & Kindred Products,October,2013,Q4,October 2013,108570660,402408483,293837823
Food & Kindred Products,November,2013,Q4,November 2013,142366260,418825354,276459094
Food & Kindred Products,December,2013,Q4,December 2013,38601339,393549843,354948504
Food & Kindred Products,January,2014,Q1,January 2014,14161648,377229458,363067810
Food & Kindred Products,February,2014,Q1,February 2014,120115724,385564390,265448666
Food & Kindred Products,March,2014,Q1,March 2014,219818725,471527081,251708356
Food & Kindred Products,April,2014,Q2,April 2014,84197678,380317600,296119922
Food & Kindred Products,May,2014,Q2,May 2014,62044674,370026793,307982119
Food & Kindred Products,June,2014,Q2,June 2014,57656983,373100871,315443888
Food & Kindred Products,July,2014,Q3,July 2014,50085730,372161122,322075392
Food & Kindred Products,August,2014,Q3,August 2014,44692478,327695273,283002795
Food & Kindred Products,September,2014,Q3,September 2014,-258451,278579673,278838124
Food & Kindred Products,October,2014,Q4,October 2014,21741328,314089907,292348579
Food & Kindred Products,November,2014,Q4,November 2014,16852871,301935222,285082351
Food & Kindred Products,December,2014,Q4,December 2014,-3049944,315972992,319022936
Food & Kindred Products,January,2015,Q1,January 2015,-99772221,209154066,308926287
Food & Kindred Products,February,2015,Q1,February 2015,-14862514,238458282,253320796
Food & Kindred Products,March,2015,Q1,March 2015,13763453,325560337,311796884
Food & Kindred Products,April,2015,Q2,April 2015,26355499,321043195,294687696
Food & Kindred Products,May,2015,Q2,May 2015,11425081,319996311,308571230
Food & Kindred Products,June,2015,Q2,June 2015,-14938256,286243602,301181858
Food & Kindred Products,July,2015,Q3,July 2015,-5612583,296870133,302482716
Food & Kindred Products,August,2015,Q3,August 2015,-7786856,284747348,292534204
Food & Kindred Products,September,2015,Q3,September 2015,-48368292,237346721,285715013
Food & Kindred Products,October,2015,Q4,October 2015,-23858846,256099968,279958814
Food & Kindred Products,November,2015,Q4,November 2015,-13940849,265127325,279068174
Food & Kindred Products,December,2015,Q4,December 2015,-67169797,260267094,327436891
Food & Kindred Products,January,2016,Q1,January 2016,-92287489,226101792,318389281
Food & Kindred Products,February,2016,Q1,February 2016,-25709049,265108985,290818034
Food & Kindred Products,March,2016,Q1,March 2016,31501130,269399399,237898269
Food & Kindred Products,April,2016,Q2,April 2016,-12870765,255563141,268433906
Food & Kindred Products,May,2016,Q2,May 2016,-12047146,289060351,301107497
Food & Kindred Products,June,2016,Q2,June 2016,-36863384,270293542,307156926
Food & Kindred Products,July,2016,Q3,July 2016,-28963885,274325972,303289857
Food & Kindred Products,August,2016,Q3,August 2016,-38991454,277900915,316892369
Food & Kindred Products,September,2016,Q3,September 2016,-9904856,270278408,280183264
Food & Kindred Products,October,2016,Q4,October 2016,-538797,295543460,296082257
Food & Kindred Products,November,2016,Q4,November 2016,2824702,317090657,314265955
Food & Kindred Products,December,2016,Q4,December 2016,-39080194,293904788,332984982
Food & Kindred Products,January,2017,Q1,January 2017,-107662497,240623739,348286236
Food & Kindred Products,February,2017,Q1,February 2017,-523518,289222344,289745862
Food & Kindred Products,March,2017,Q1,March 2017,22559430,292797420,270237990
Food & Kindred Products,April,2017,Q2,April 2017,-21448913,269727072,291175985
Food & Kindred Products,May,2017,Q2,May 2017,-29614540,289291803,318906343
Food & Kindred Products,June,2017,Q2,June 2017,-54390814,271029251,325420065
Food & Kindred Products,July,2017,Q3,July 2017,-65308987,257626986,322935973
Food & Kindred Products,August,2017,Q3,August 2017,-49004697,266844847,315849544
Food & Kindred Products,September,2017,Q3,September 2017,-49352822,254538415,303891237
Food & Kindred Products,October,2017,Q4,October 2017,-23638669,285638764,309277433
Food & Kindred Products,November,2017,Q4,November 2017,-18455753,287383923,305839676
Food & Kindred Products,December,2017,Q4,December 2017,-78728895,297648700,376377595
Food & Kindred Products,January,2018,Q1,January 2018,-149534913,227652830,377187743
Food & Kindred Products,February,2018,Q1,February 2018,-56200188,258551927,314752115
Food & Kindred Products,March,2018,Q1,March 2018,-9506897,292718228,302225125
Food & Kindred Products,April,2018,Q2,April 2018,2852605,303967915,301115310
Food & Kindred Products,May,2018,Q2,May 2018,-76943476,280358064,357301540
Food & Kindred Products,June,2018,Q2,June 2018,-108008531,249735141,357743672
Food & Kindred Products,July,2018,Q3,July 2018,-147368053,218633175,366001228
Food & Kindred Products,August,2018,Q3,August 2018,-138019217,224547434,362566651
Food & Kindred Products,September,2018,Q3,September 2018,-123537029,191497924,315034953
Food & Kindred Products,October,2018,Q4,October 2018,-93891333,224843805,318735138
Food & Kindred Products,November,2018,Q4,November 2018,-76804697,266658166,343462863
Food & Kindred Products,December,2018,Q4,December 2018,-287545304,218464583,506009887
Food & Kindred Products,January,2019,Q1,January 2019,-48138623,198451773,246590396
Food & Kindred Products,February,2019,Q1,February 2019,-27982184,203038654,231020838
Food & Kindred Products,March,2019,Q1,March 2019,27814596,222368320,194553724
Food & Kindred Products,April,2019,Q2,April 2019,-11101664,225498032,236599696
Food & Kindred Products,May,2019,Q2,May 2019,-22061283,233142229,255203512
Food & Kindred Products,June,2019,Q2,June 2019,12058961,252797093,240738132
Food & Kindred Products,July,2019,Q3,July 2019,44424542,294628950,250204408
Food & Kindred Products,August,2019,Q3,August 2019,26123292,281679574,255556282
Food & Kindred Products,September,2019,Q3,September 2019,-18100051,258869278,276969329
Food & Kindred Products,October,2019,Q4,October 2019,61696290,300972569,239276279
Food & Kindred Products,November,2019,Q4,November 2019,146270633,363083240,216812607
Food & Kindred Products,December,2019,Q4,December 2019,143194250,402940453,259746203
Beverages & Tobacco Products,January,2002,Q1,January 2002,-4622628,282381,4905009
Beverages & Tobacco Products,February,2002,Q1,February 2002,-1932913,361850,2294763
Beverages & Tobacco Products,March,2002,Q1,March 2002,-3375169,539427,3914596
Beverages & Tobacco Products,April,2002,Q2,April 2002,-4204307,141798,4346105
Beverages & Tobacco Products,May,2002,Q2,May 2002,-4938829,278761,5217590
Beverages & Tobacco Products,June,2002,Q2,June 2002,-3191173,1140168,4331341
Beverages & Tobacco Products,July,2002,Q3,July 2002,-3222598,463194,3685792
Beverages & Tobacco Products,August,2002,Q3,August 2002,-2202011,292397,2494408
Beverages & Tobacco Products,September,2002,Q3,September 2002,-1202389,846447,2048836
Beverages & Tobacco Products,October,2002,Q4,October 2002,-692014,574235,1266249
Beverages & Tobacco Products,November,2002,Q4,November 2002,-1701898,298562,2000460
Beverages & Tobacco Products,December,2002,Q4,December 2002,-2265082,522846,2787928
Beverages & Tobacco Products,January,2003,Q1,January 2003,-1689305,415313,2104618
Beverages & Tobacco Products,February,2003,Q1,February 2003,-1013627,297163,1310790
Beverages & Tobacco Products,March,2003,Q1,March 2003,-971547,413607,1385154
Beverages & Tobacco Products,April,2003,Q2,April 2003,-1540681,589160,2129841
Beverages & Tobacco Products,May,2003,Q2,May 2003,-2359302,192607,2551909
Beverages & Tobacco Products,June,2003,Q2,June 2003,-2231397,204830,2436227
Beverages & Tobacco Products,July,2003,Q3,July 2003,-1583354,934280,2517634
Beverages & Tobacco Products,August,2003,Q3,August 2003,-3178617,735709,3914326
Beverages & Tobacco Products,September,2003,Q3,September 2003,-2796115,364299,3160414
Beverages & Tobacco Products,October,2003,Q4,October 2003,-2249692,791727,3041419
Beverages & Tobacco Products,November,2003,Q4,November 2003,-1102597,1135672,2238269
Beverages & Tobacco Products,December,2003,Q4,December 2003,-1150919,1329649,2480568
Beverages & Tobacco Products,January,2004,Q1,January 2004,-5176920,558550,5735470
Beverages & Tobacco Products,February,2004,Q1,February 2004,-516491,1005239,1521730
Beverages & Tobacco Products,March,2004,Q1,March 2004,-964078,1388971,2353049
Beverages & Tobacco Products,April,2004,Q2,April 2004,-1718450,1280084,2998534
Beverages & Tobacco Products,May,2004,Q2,May 2004,-2315045,1264367,3579412
Beverages & Tobacco Products,June,2004,Q2,June 2004,-2583230,951961,3535191
Beverages & Tobacco Products,July,2004,Q3,July 2004,-2996267,1219959,4216226
Beverages & Tobacco Products,August,2004,Q3,August 2004,-2529078,520445,3049523
Beverages & Tobacco Products,September,2004,Q3,September 2004,-2454120,487799,2941919
Beverages & Tobacco Products,October,2004,Q4,October 2004,-1913937,1003349,2917286
Beverages & Tobacco Products,November,2004,Q4,November 2004,-413960,1752778,2166738
Beverages & Tobacco Products,December,2004,Q4,December 2004,-1498920,1314955,2813875
Beverages & Tobacco Products,January,2005,Q1,January 2005,-1631816,1497939,3129755
Beverages & Tobacco Products,February,2005,Q1,February 2005,-726431,940127,1666558
Beverages & Tobacco Products,March,2005,Q1,March 2005,-222429,874317,1096746
Beverages & Tobacco Products,April,2005,Q2,April 2005,-1415966,1074383,2490349
Beverages & Tobacco Products,May,2005,Q2,May 2005,-778037,1195673,1973710
Beverages & Tobacco Products,June,2005,Q2,June 2005,-3303390,404868,3708258
Beverages & Tobacco Products,July,2005,Q3,July 2005,-1672797,1212824,2885621
Beverages & Tobacco Products,August,2005,Q3,August 2005,-823992,841299,1665291
Beverages & Tobacco Products,September,2005,Q3,September 2005,-786503,1529096,2315599
Beverages & Tobacco Products,October,2005,Q4,October 2005,-377352,1682952,2060304
Beverages & Tobacco Products,November,2005,Q4,November 2005,-471647,1099241,1570888
Beverages & Tobacco Products,December,2005,Q4,December 2005,-1075373,1260892,2336265
Beverages & Tobacco Products,January,2006,Q1,January 2006,-995320,1394414,2389734
Beverages & Tobacco Products,February,2006,Q1,February 2006,-1118980,621133,1740113
Beverages & Tobacco Products,March,2006,Q1,March 2006,382947,1915375,1532428
Beverages & Tobacco Products,April,2006,Q2,April 2006,-1255118,1249956,2505074
Beverages & Tobacco Products,May,2006,Q2,May 2006,-929682,1893464,2823146
Beverages & Tobacco Products,June,2006,Q2,June 2006,-1990399,1707580,3697979
Beverages & Tobacco Products,July,2006,Q3,July 2006,-1157981,1931455,3089436
Beverages & Tobacco Products,August,2006,Q3,August 2006,-2620062,2273572,4893634
Beverages & Tobacco Products,September,2006,Q3,September 2006,-2036362,1410109,3446471
Beverages & Tobacco Products,October,2006,Q4,October 2006,-1174196,1521136,2695332
Beverages & Tobacco Products,November,2006,Q4,November 2006,-1522563,1816319,3338882
Beverages & Tobacco Products,December,2006,Q4,December 2006,942264,2597140,1654876
Beverages & Tobacco Products,January,2007,Q1,January 2007,-2100019,1434631,3534650
Beverages & Tobacco Products,February,2007,Q1,February 2007,-214853,1808234,2023087
Beverages & Tobacco Products,March,2007,Q1,March 2007,-788666,2083647,2872313
Beverages & Tobacco Products,April,2007,Q2,April 2007,-1126858,1912963,3039821
Beverages & Tobacco Products,May,2007,Q2,May 2007,-2261919,2002443,4264362
Beverages & Tobacco Products,June,2007,Q2,June 2007,-617018,3088345,3705363
Beverages & Tobacco Products,July,2007,Q3,July 2007,-1762173,1793862,3556035
Beverages & Tobacco Products,August,2007,Q3,August 2007,-1141067,2172807,3313874
Beverages & Tobacco Products,September,2007,Q3,September 2007,-1190693,2803047,3993740
Beverages & Tobacco Products,October,2007,Q4,October 2007,-364906,2738500,3103406
Beverages & Tobacco Products,November,2007,Q4,November 2007,835835,2946507,2110672
Beverages & Tobacco Products,December,2007,Q4,December 2007,-223790,2965972,3189762
Beverages & Tobacco Products,January,2008,Q1,January 2008,1309147,3694419,2385272
Beverages & Tobacco Products,February,2008,Q1,February 2008,962255,3093912,2131657
Beverages & Tobacco Products,March,2008,Q1,March 2008,575922,2755623,2179701
Beverages & Tobacco Products,April,2008,Q2,April 2008,-619708,3328870,3948578
Beverages & Tobacco Products,May,2008,Q2,May 2008,-893185,3342701,4235886
Beverages & Tobacco Products,June,2008,Q2,June 2008,-1856204,2277980,4134184
Beverages & Tobacco Products,July,2008,Q3,July 2008,-1706841,1910459,3617300
Beverages & Tobacco Products,August,2008,Q3,August 2008,-1200672,2369902,3570574
Beverages & Tobacco Products,September,2008,Q3,September 2008,1118612,3840202,2721590
Beverages & Tobacco Products,October,2008,Q4,October 2008,-723412,1968927,2692339
Beverages & Tobacco Products,November,2008,Q4,November 2008,2076987,4261549,2184562
Beverages & Tobacco Products,December,2008,Q4,December 2008,1805144,4711500,2906356
Beverages & Tobacco Products,January,2009,Q1,January 2009,-494128,2285929,2780057
Beverages & Tobacco Products,February,2009,Q1,February 2009,1069049,2404496,1335447
Beverages & Tobacco Products,March,2009,Q1,March 2009,1698204,4050879,2352675
Beverages & Tobacco Products,April,2009,Q2,April 2009,-1582778,3506771,5089549
Beverages & Tobacco Products,May,2009,Q2,May 2009,1934898,3932415,1997517
Beverages & Tobacco Products,June,2009,Q2,June 2009,2943453,5282762,2339309
Beverages & Tobacco Products,July,2009,Q3,July 2009,3087118,6347728,3260610
Beverages & Tobacco Products,August,2009,Q3,August 2009,21259403,23358346,2098943
Beverages & Tobacco Products,September,2009,Q3,September 2009,16588330,18893819,2305489
Beverages & Tobacco Products,October,2009,Q4,October 2009,24730750,28846259,4115509
Beverages & Tobacco Products,November,2009,Q4,November 2009,20622003,23560401,2938398
Beverages & Tobacco Products,December,2009,Q4,December 2009,22522103,25284501,2762398
Beverages & Tobacco Products,January,2010,Q1,January 2010,21654440,23821616,2167176
Beverages & Tobacco Products,February,2010,Q1,February 2010,30551281,33188197,2636916
Beverages & Tobacco Products,March,2010,Q1,March 2010,26153548,28509720,2356172
Beverages & Tobacco Products,April,2010,Q2,April 2010,33699642,35406058,1706416
Beverages & Tobacco Products,May,2010,Q2,May 2010,60373413,65347154,4973741
Beverages & Tobacco Products,June,2010,Q2,June 2010,58185152,61650475,3465323
Beverages & Tobacco Products,July,2010,Q3,July 2010,68501905,71113252,2611347
Beverages & Tobacco Products,August,2010,Q3,August 2010,53096449,58057235,4960786
Beverages & Tobacco Products,September,2010,Q3,September 2010,41547887,43949587,2401700
Beverages & Tobacco Products,October,2010,Q4,October 2010,47144722,49505302,2360580
Beverages & Tobacco Products,November,2010,Q4,November 2010,38585279,41487796,2902517
Beverages & Tobacco Products,December,2010,Q4,December 2010,41973491,45772730,3799239
Beverages & Tobacco Products,January,2011,Q1,January 2011,28072285,31199600,3127315
Beverages & Tobacco Products,February,2011,Q1,February 2011,29045974,31386429,2340455
Beverages & Tobacco Products,March,2011,Q1,March 2011,20062188,23039651,2977463
Beverages & Tobacco Products,April,2011,Q2,April 2011,16018621,19279866,3261245
Beverages & Tobacco Products,May,2011,Q2,May 2011,16767455,22418369,5650914
Beverages & Tobacco Products,June,2011,Q2,June 2011,24283835,26380245,2096410
Beverages & Tobacco Products,July,2011,Q3,July 2011,29451612,34455595,5003983
Beverages & Tobacco Products,August,2011,Q3,August 2011,37043462,39101636,2058174
Beverages & Tobacco Products,September,2011,Q3,September 2011,50060755,51684776,1624021
Beverages & Tobacco Products,October,2011,Q4,October 2011,44386379,49363593,4977214
Beverages & Tobacco Products,November,2011,Q4,November 2011,42938984,47142216,4203232
Beverages & Tobacco Products,December,2011,Q4,December 2011,33404302,37318041,3913739
Beverages & Tobacco Products,January,2012,Q1,January 2012,28315778,34365106,6049328
Beverages & Tobacco Products,February,2012,Q1,February 2012,42092978,46045598,3952620
Beverages & Tobacco Products,March,2012,Q1,March 2012,53652983,56676195,3023212
Beverages & Tobacco Products,April,2012,Q2,April 2012,77012586,83928245,6915659
Beverages & Tobacco Products,May,2012,Q2,May 2012,72697202,79966696,7269494
Beverages & Tobacco Products,June,2012,Q2,June 2012,74100265,80276386,6176121
Beverages & Tobacco Products,July,2012,Q3,July 2012,68976748,78447980,9471232
Beverages & Tobacco Products,August,2012,Q3,August 2012,46809337,51197428,4388091
Beverages & Tobacco Products,September,2012,Q3,September 2012,58803514,62816996,4013482
Beverages & Tobacco Products,October,2012,Q4,October 2012,48083690,51965873,3882183
Beverages & Tobacco Products,November,2012,Q4,November 2012,30838359,37610135,6771776
Beverages & Tobacco Products,December,2012,Q4,December 2012,38756977,43270111,4513134
Beverages & Tobacco Products,January,2013,Q1,January 2013,39370294,44810099,5439805
Beverages & Tobacco Products,February,2013,Q1,February 2013,53585296,57287743,3702447
Beverages & Tobacco Products,March,2013,Q1,March 2013,66780881,70946166,4165285
Beverages & Tobacco Products,April,2013,Q2,April 2013,91600689,96746898,5146209
Beverages & Tobacco Products,May,2013,Q2,May 2013,84411745,90798152,6386407
Beverages & Tobacco Products,June,2013,Q2,June 2013,96947494,103138167,6190673
Beverages & Tobacco Products,July,2013,Q3,July 2013,147234819,152258685,5023866
Beverages & Tobacco Products,August,2013,Q3,August 2013,182222154,187491659,5269505
Beverages & Tobacco Products,September,2013,Q3,September 2013,149498602,153694100,4195498
Beverages & Tobacco Products,October,2013,Q4,October 2013,180333026,186363263,6030237
Beverages & Tobacco Products,November,2013,Q4,November 2013,181626862,186090136,4463274
Beverages & Tobacco Products,December,2013,Q4,December 2013,153075848,161150582,8074734
Beverages & Tobacco Products,January,2014,Q1,January 2014,95944664,105721564,9776900
Beverages & Tobacco Products,February,2014,Q1,February 2014,134409423,139129860,4720437
Beverages & Tobacco Products,March,2014,Q1,March 2014,172563116,175829405,3266289
Beverages & Tobacco Products,April,2014,Q2,April 2014,138738156,144143980,5405824
Beverages & Tobacco Products,May,2014,Q2,May 2014,167997014,174910983,6913969
Beverages & Tobacco Products,June,2014,Q2,June 2014,179889909,186719378,6829469
Beverages & Tobacco Products,July,2014,Q3,July 2014,163456576,170980810,7524234
Beverages & Tobacco Products,August,2014,Q3,August 2014,133838485,139386735,5548250
Beverages & Tobacco Products,September,2014,Q3,September 2014,50815511,54333803,3518292
Beverages & Tobacco Products,October,2014,Q4,October 2014,7365192,13609323,6244131
Beverages & Tobacco Products,November,2014,Q4,November 2014,9071882,14046371,4974489
Beverages & Tobacco Products,December,2014,Q4,December 2014,30153401,34635878,4482477
Beverages & Tobacco Products,January,2015,Q1,January 2015,38255701,44233493,5977792
Beverages & Tobacco Products,February,2015,Q1,February 2015,69139686,73654293,4514607
Beverages & Tobacco Products,March,2015,Q1,March 2015,121978587,128058052,6079465
Beverages & Tobacco Products,April,2015,Q2,April 2015,159883854,165660347,5776493
Beverages & Tobacco Products,May,2015,Q2,May 2015,250275549,257160659,6885110
Beverages & Tobacco Products,June,2015,Q2,June 2015,238629694,243173991,4544297
Beverages & Tobacco Products,July,2015,Q3,July 2015,250154933,256962109,6807176
Beverages & Tobacco Products,August,2015,Q3,August 2015,192211363,199930877,7719514
Beverages & Tobacco Products,September,2015,Q3,September 2015,137664140,141344244,3680104
Beverages & Tobacco Products,October,2015,Q4,October 2015,88850882,93676724,4825842
Beverages & Tobacco Products,November,2015,Q4,November 2015,64195718,69105375,4909657
Beverages & Tobacco Products,December,2015,Q4,December 2015,43005806,51292155,8286349
Beverages & Tobacco Products,January,2016,Q1,January 2016,40503503,49244410,8740907
Beverages & Tobacco Products,February,2016,Q1,February 2016,42716058,47475392,4759334
Beverages & Tobacco Products,March,2016,Q1,March 2016,31750271,34889022,3138751
Beverages & Tobacco Products,April,2016,Q2,April 2016,28907076,33906542,4999466
Beverages & Tobacco Products,May,2016,Q2,May 2016,50178389,60548684,10370295
Beverages & Tobacco Products,June,2016,Q2,June 2016,84405243,88586222,4180979
Beverages & Tobacco Products,July,2016,Q3,July 2016,89830335,97314376,7484041
Beverages & Tobacco Products,August,2016,Q3,August 2016,52484118,61970854,9486736
Beverages & Tobacco Products,September,2016,Q3,September 2016,28917409,37311933,8394524
Beverages & Tobacco Products,October,2016,Q4,October 2016,24895871,29873901,4978030
Beverages & Tobacco Products,November,2016,Q4,November 2016,16948558,24068106,7119548
Beverages & Tobacco Products,December,2016,Q4,December 2016,11566457,20661198,9094741
Beverages & Tobacco Products,January,2017,Q1,January 2017,14362418,22743666,8381248
Beverages & Tobacco Products,February,2017,Q1,February 2017,8985546,16985356,7999810
Beverages & Tobacco Products,March,2017,Q1,March 2017,7100220,14222598,7122378
Beverages & Tobacco Products,April,2017,Q2,April 2017,9167892,18980075,9812183
Beverages & Tobacco Products,May,2017,Q2,May 2017,8050687,16621751,8571064
Beverages & Tobacco Products,June,2017,Q2,June 2017,3501878,11285533,7783655
Beverages & Tobacco Products,July,2017,Q3,July 2017,5250763,10570700,5319937
Beverages & Tobacco Products,August,2017,Q3,August 2017,758033,9158822,8400789
Beverages & Tobacco Products,September,2017,Q3,September 2017,5662414,10724958,5062544
Beverages & Tobacco Products,October,2017,Q4,October 2017,59933,10669949,10610016
Beverages & Tobacco Products,November,2017,Q4,November 2017,4236184,13815741,9579557
Beverages & Tobacco Products,December,2017,Q4,December 2017,6116486,16784831,10668345
Beverages & Tobacco Products,January,2018,Q1,January 2018,-4953920,8090825,13044745
Beverages & Tobacco Products,February,2018,Q1,February 2018,6072717,12203600,6130883
Beverages & Tobacco Products,March,2018,Q1,March 2018,7439981,12629838,5189857
Beverages & Tobacco Products,April,2018,Q2,April 2018,7183103,15580534,8397431
Beverages & Tobacco Products,May,2018,Q2,May 2018,5869279,13939398,8070119
Beverages & Tobacco Products,June,2018,Q2,June 2018,-3776941,13046730,16823671
Beverages & Tobacco Products,July,2018,Q3,July 2018,-463648,10376470,10840118
Beverages & Tobacco Products,August,2018,Q3,August 2018,-4386544,9320641,13707185
Beverages & Tobacco Products,September,2018,Q3,September 2018,-2045093,10480476,12525569
Beverages & Tobacco Products,October,2018,Q4,October 2018,4063363,11443168,7379805
Beverages & Tobacco Products,November,2018,Q4,November 2018,6876247,14118720,7242473
Beverages & Tobacco Products,December,2018,Q4,December 2018,-5365723,7018557,12384280
Beverages & Tobacco Products,January,2019,Q1,January 2019,-8799550,4132563,12932113
Beverages & Tobacco Products,February,2019,Q1,February 2019,-231215,6127325,6358540
Beverages & Tobacco Products,March,2019,Q1,March 2019,5651048,9250112,3599064
Beverages & Tobacco Products,April,2019,Q2,April 2019,2555148,9599153,7044005
Beverages & Tobacco Products,May,2019,Q2,May 2019,-5446082,9107684,14553766
Beverages & Tobacco Products,June,2019,Q2,June 2019,-261023,11750067,12011090
Beverages & Tobacco Products,July,2019,Q3,July 2019,958695,9232382,8273687
Beverages & Tobacco Products,August,2019,Q3,August 2019,9597090,14147888,4550798
Beverages & Tobacco Products,September,2019,Q3,September 2019,4262211,9444761,5182550
Beverages & Tobacco Products,October,2019,Q4,October 2019,10272088,14594794,4322706
Beverages & Tobacco Products,November,2019,Q4,November 2019,9049585,16354074,7304489
Beverages & Tobacco Products,December,2019,Q4,December 2019,3297443,13765150,10467707
Textiles & Fabrics,January,2002,Q1,January 2002,-36380298,7435734,43816032
Textiles & Fabrics,February,2002,Q1,February 2002,-20126454,7150182,27276636
Textiles & Fabrics,March,2002,Q1,March 2002,-20408618,9020149,29428767
Textiles & Fabrics,April,2002,Q2,April 2002,-27917684,10748096,38665780
Textiles & Fabrics,May,2002,Q2,May 2002,-29316298,13106675,42422973
Textiles & Fabrics,June,2002,Q2,June 2002,-31010817,11156127,42166944
Textiles & Fabrics,July,2002,Q3,July 2002,-38804720,12146898,50951618
Textiles & Fabrics,August,2002,Q3,August 2002,-32606101,10189028,42795129
Textiles & Fabrics,September,2002,Q3,September 2002,-29315397,9717098,39032495
Textiles & Fabrics,October,2002,Q4,October 2002,-20012739,13367009,33379748
Textiles & Fabrics,November,2002,Q4,November 2002,-23578201,12811289,36389490
Textiles & Fabrics,December,2002,Q4,December 2002,-25786285,13708637,39494922
Textiles & Fabrics,January,2003,Q1,January 2003,-37538081,8946179,46484260
Textiles & Fabrics,February,2003,Q1,February 2003,-24711866,10392985,35104851
Textiles & Fabrics,March,2003,Q1,March 2003,-23745953,13509878,37255831
Textiles & Fabrics,April,2003,Q2,April 2003,-32365953,13555611,45921564
Textiles & Fabrics,May,2003,Q2,May 2003,-30427917,17924049,48351966
Textiles & Fabrics,June,2003,Q2,June 2003,-32021850,14165420,46187270
Textiles & Fabrics,July,2003,Q3,July 2003,-44708181,9904438,54612619
Textiles & Fabrics,August,2003,Q3,August 2003,-30583331,11743567,42326898
Textiles & Fabrics,September,2003,Q3,September 2003,-31405641,14117060,45522701
Textiles & Fabrics,October,2003,Q4,October 2003,-38898550,12816376,51714926
Textiles & Fabrics,November,2003,Q4,November 2003,-20483642,20161506,40645148
Textiles & Fabrics,December,2003,Q4,December 2003,-34912297,14666155,49578452
Textiles & Fabrics,January,2004,Q1,January 2004,-52524443,13060209,65584652
Textiles & Fabrics,February,2004,Q1,February 2004,-20330583,14856805,35187388
Textiles & Fabrics,March,2004,Q1,March 2004,-30255293,19407282,49662575
Textiles & Fabrics,April,2004,Q2,April 2004,-35999705,16869362,52869067
Textiles & Fabrics,May,2004,Q2,May 2004,-40044530,17349410,57393940
Textiles & Fabrics,June,2004,Q2,June 2004,-53379165,16077560,69456725
Textiles & Fabrics,July,2004,Q3,July 2004,-49358878,18193662,67552540
Textiles & Fabrics,August,2004,Q3,August 2004,-44417059,17018595,61435654
Textiles & Fabrics,September,2004,Q3,September 2004,-36042133,14198522,50240655
Textiles & Fabrics,October,2004,Q4,October 2004,-31809422,18865274,50674696
Textiles & Fabrics,November,2004,Q4,November 2004,-38366811,17330768,55697579
Textiles & Fabrics,December,2004,Q4,December 2004,-38793513,20853581,59647094
Textiles & Fabrics,January,2005,Q1,January 2005,-51086448,16434073,67520521
Textiles & Fabrics,February,2005,Q1,February 2005,-50082466,18929881,69012347
Textiles & Fabrics,March,2005,Q1,March 2005,-44883028,19776136,64659164
Textiles & Fabrics,April,2005,Q2,April 2005,-53901029,23880847,77781876
Textiles & Fabrics,May,2005,Q2,May 2005,-60157251,26571692,86728943
Textiles & Fabrics,June,2005,Q2,June 2005,-68673224,23992100,92665324
Textiles & Fabrics,July,2005,Q3,July 2005,-67561546,23973897,91535443
Textiles & Fabrics,August,2005,Q3,August 2005,-74204964,19100192,93305156
Textiles & Fabrics,September,2005,Q3,September 2005,-64380969,19638897,84019866
Textiles & Fabrics,October,2005,Q4,October 2005,-59488341,23829655,83317996
Textiles & Fabrics,November,2005,Q4,November 2005,-54756086,25248330,80004416
Textiles & Fabrics,December,2005,Q4,December 2005,-64832825,21976026,86808851
Textiles & Fabrics,January,2006,Q1,January 2006,-80082043,18905894,98987937
Textiles & Fabrics,February,2006,Q1,February 2006,-42725439,21924526,64649965
Textiles & Fabrics,March,2006,Q1,March 2006,-48922125,26572166,75494291
Textiles & Fabrics,April,2006,Q2,April 2006,-58091315,34163710,92255025
Textiles & Fabrics,May,2006,Q2,May 2006,-67680025,32403340,100083365
Textiles & Fabrics,June,2006,Q2,June 2006,-61044756,41096028,102140784
Textiles & Fabrics,July,2006,Q3,July 2006,-71502057,31530259,103032316
Textiles & Fabrics,August,2006,Q3,August 2006,-74489606,25324121,99813727
Textiles & Fabrics,September,2006,Q3,September 2006,-60818610,28412683,89231293
Textiles & Fabrics,October,2006,Q4,October 2006,-64678535,30700685,95379220
Textiles & Fabrics,November,2006,Q4,November 2006,-71093775,27228800,98322575
Textiles & Fabrics,December,2006,Q4,December 2006,-72230542,29728160,101958702
Textiles & Fabrics,January,2007,Q1,January 2007,-81365782,25960799,107326581
Textiles & Fabrics,February,2007,Q1,February 2007,-65848125,28577219,94425344
Textiles & Fabrics,March,2007,Q1,March 2007,-47716924,32111708,79828632
Textiles & Fabrics,April,2007,Q2,April 2007,-66189791,32120175,98309966
Textiles & Fabrics,May,2007,Q2,May 2007,-73962278,31862665,105824943
Textiles & Fabrics,June,2007,Q2,June 2007,-72510421,37397353,109907774
Textiles & Fabrics,July,2007,Q3,July 2007,-82901871,24837867,107739738
Textiles & Fabrics,August,2007,Q3,August 2007,-67492597,31597787,99090384
Textiles & Fabrics,September,2007,Q3,September 2007,-62747541,34242538,96990079
Textiles & Fabrics,October,2007,Q4,October 2007,-76823177,28927143,105750320
Textiles & Fabrics,November,2007,Q4,November 2007,-77377089,28918693,106295782
Textiles & Fabrics,December,2007,Q4,December 2007,-77743344,31268463,109011807
Textiles & Fabrics,January,2008,Q1,January 2008,-84361396,30135586,114496982
Textiles & Fabrics,February,2008,Q1,February 2008,-75639667,27684933,103324600
Textiles & Fabrics,March,2008,Q1,March 2008,-49109905,35653535,84763440
Textiles & Fabrics,April,2008,Q2,April 2008,-83112859,34738529,117851388
Textiles & Fabrics,May,2008,Q2,May 2008,-94281670,34886623,129168293
Textiles & Fabrics,June,2008,Q2,June 2008,-71815327,42336289,114151616
Textiles & Fabrics,July,2008,Q3,July 2008,-85518038,37104145,122622183
Textiles & Fabrics,August,2008,Q3,August 2008,-81978184,34997299,116975483
Textiles & Fabrics,September,2008,Q3,September 2008,-90664448,27597776,118262224
Textiles & Fabrics,October,2008,Q4,October 2008,-74119753,33605980,107725733
Textiles & Fabrics,November,2008,Q4,November 2008,-64146814,27703007,91849821
Textiles & Fabrics,December,2008,Q4,December 2008,-68600197,23300567,91900764
Textiles & Fabrics,January,2009,Q1,January 2009,-70703128,19397452,90100580
Textiles & Fabrics,February,2009,Q1,February 2009,-39737024,22573455,62310479
Textiles & Fabrics,March,2009,Q1,March 2009,-46920565,21091913,68012478
Textiles & Fabrics,April,2009,Q2,April 2009,-64716126,23816528,88532654
Textiles & Fabrics,May,2009,Q2,May 2009,-61402781,28175936,89578717
Textiles & Fabrics,June,2009,Q2,June 2009,-64936032,24575563,89511595
Textiles & Fabrics,July,2009,Q3,July 2009,-66095610,25031010,91126620
Textiles & Fabrics,August,2009,Q3,August 2009,-62834826,24326432,87161258
Textiles & Fabrics,September,2009,Q3,September 2009,-62354344,27815578,90169922
Textiles & Fabrics,October,2009,Q4,October 2009,-60820577,30236612,91057189
Textiles & Fabrics,November,2009,Q4,November 2009,-62819491,28194525,91014016
Textiles & Fabrics,December,2009,Q4,December 2009,-70576628,33158220,103734848
Textiles & Fabrics,January,2010,Q1,January 2010,-77265902,26272673,103538575
Textiles & Fabrics,February,2010,Q1,February 2010,-69974271,26199195,96173466
Textiles & Fabrics,March,2010,Q1,March 2010,-46398790,39068401,85467191
Textiles & Fabrics,April,2010,Q2,April 2010,-75145104,30344622,105489726
Textiles & Fabrics,May,2010,Q2,May 2010,-82222014,35774620,117996634
Textiles & Fabrics,June,2010,Q2,June 2010,-108805511,33447392,142252903
Textiles & Fabrics,July,2010,Q3,July 2010,-103409692,33957786,137367478
Textiles & Fabrics,August,2010,Q3,August 2010,-88816683,35930242,124746925
Textiles & Fabrics,September,2010,Q3,September 2010,-80819849,35702301,116522150
Textiles & Fabrics,October,2010,Q4,October 2010,-73126598,40437874,113564472
Textiles & Fabrics,November,2010,Q4,November 2010,-78615028,38317542,116932570
Textiles & Fabrics,December,2010,Q4,December 2010,-90684549,33197009,123881558
Textiles & Fabrics,January,2011,Q1,January 2011,-100135973,37464998,137600971
Textiles & Fabrics,February,2011,Q1,February 2011,-89540651,34214267,123754918
Textiles & Fabrics,March,2011,Q1,March 2011,-53442530,37029407,90471937
Textiles & Fabrics,April,2011,Q2,April 2011,-94236557,36241850,130478407
Textiles & Fabrics,May,2011,Q2,May 2011,-126711284,37100635,163811919
Textiles & Fabrics,June,2011,Q2,June 2011,-127528237,37010695,164538932
Textiles & Fabrics,July,2011,Q3,July 2011,-117899805,37665811,155565616
Textiles & Fabrics,August,2011,Q3,August 2011,-110625316,47500882,158126198
Textiles & Fabrics,September,2011,Q3,September 2011,-90013001,54423545,144436546
Textiles & Fabrics,October,2011,Q4,October 2011,-97355102,38759103,136114205
Textiles & Fabrics,November,2011,Q4,November 2011,-107899706,39853749,147753455
Textiles & Fabrics,December,2011,Q4,December 2011,-127368495,32236446,159604941
Textiles & Fabrics,January,2012,Q1,January 2012,-152252338,35508721,187761059
Textiles & Fabrics,February,2012,Q1,February 2012,-97990557,35911888,133902445
Textiles & Fabrics,March,2012,Q1,March 2012,-91246121,37180545,128426666
Textiles & Fabrics,April,2012,Q2,April 2012,-136302890,40857654,177160544
Textiles & Fabrics,May,2012,Q2,May 2012,-161383851,38786731,200170582
Textiles & Fabrics,June,2012,Q2,June 2012,-140300238,44423015,184723253
Textiles & Fabrics,July,2012,Q3,July 2012,-138014602,41546936,179561538
Textiles & Fabrics,August,2012,Q3,August 2012,-122375470,39491520,161866990
Textiles & Fabrics,September,2012,Q3,September 2012,-96630443,47338800,143969243
Textiles & Fabrics,October,2012,Q4,October 2012,-109043254,46048759,155092013
Textiles & Fabrics,November,2012,Q4,November 2012,-106874296,41703554,148577850
Textiles & Fabrics,December,2012,Q4,December 2012,-110361344,40471526,150832870
Textiles & Fabrics,January,2013,Q1,January 2013,-132468179,45727676,178195855
Textiles & Fabrics,February,2013,Q1,February 2013,-127127855,50999021,178126876
Textiles & Fabrics,March,2013,Q1,March 2013,-60499306,51222929,111722235
Textiles & Fabrics,April,2013,Q2,April 2013,-115584325,51105678,166690003
Textiles & Fabrics,May,2013,Q2,May 2013,-149552134,49181168,198733302
Textiles & Fabrics,June,2013,Q2,June 2013,-147122513,45399334,192521847
Textiles & Fabrics,July,2013,Q3,July 2013,-153895765,45205323,199101088
Textiles & Fabrics,August,2013,Q3,August 2013,-146828696,50530932,197359628
Textiles & Fabrics,September,2013,Q3,September 2013,-141612148,39495235,181107383
Textiles & Fabrics,October,2013,Q4,October 2013,-123147928,50018694,173166622
Textiles & Fabrics,November,2013,Q4,November 2013,-122829150,42863877,165693027
Textiles & Fabrics,December,2013,Q4,December 2013,-143087031,41616214,184703245
Textiles & Fabrics,January,2014,Q1,January 2014,-167677298,48587297,216264595
Textiles & Fabrics,February,2014,Q1,February 2014,-128245480,34908568,163154048
Textiles & Fabrics,March,2014,Q1,March 2014,-89595335,37511925,127107260
Textiles & Fabrics,April,2014,Q2,April 2014,-146717758,37581668,184299426
Textiles & Fabrics,May,2014,Q2,May 2014,-163186658,39320456,202507114
Textiles & Fabrics,June,2014,Q2,June 2014,-163650968,38154546,201805514
Textiles & Fabrics,July,2014,Q3,July 2014,-165665969,39462193,205128162
Textiles & Fabrics,August,2014,Q3,August 2014,-149019660,38140213,187159873
Textiles & Fabrics,September,2014,Q3,September 2014,-158540757,37397010,195937767
Textiles & Fabrics,October,2014,Q4,October 2014,-149557135,39772237,189329372
Textiles & Fabrics,November,2014,Q4,November 2014,-133814811,39243205,173058016
Textiles & Fabrics,December,2014,Q4,December 2014,-158868935,32902858,191771793
Textiles & Fabrics,January,2015,Q1,January 2015,-168330104,32446023,200776127
Textiles & Fabrics,February,2015,Q1,February 2015,-133862668,33469682,167332350
Textiles & Fabrics,March,2015,Q1,March 2015,-174790853,38593768,213384621
Textiles & Fabrics,April,2015,Q2,April 2015,-139787923,40247659,180035582
Textiles & Fabrics,May,2015,Q2,May 2015,-190266730,39255991,229522721
Textiles & Fabrics,June,2015,Q2,June 2015,-191457068,37153697,228610765
Textiles & Fabrics,July,2015,Q3,July 2015,-199108945,36494659,235603604
Textiles & Fabrics,August,2015,Q3,August 2015,-180583869,35924251,216508120
Textiles & Fabrics,September,2015,Q3,September 2015,-158778266,34602452,193380718
Textiles & Fabrics,October,2015,Q4,October 2015,-154790346,31727704,186518050
Textiles & Fabrics,November,2015,Q4,November 2015,-142013301,35740278,177753579
Textiles & Fabrics,December,2015,Q4,December 2015,-156930102,34705376,191635478
Textiles & Fabrics,January,2016,Q1,January 2016,-173651565,28168155,201819720
Textiles & Fabrics,February,2016,Q1,February 2016,-164221411,33236260,197457671
Textiles & Fabrics,March,2016,Q1,March 2016,-89921421,33581638,123503059
Textiles & Fabrics,April,2016,Q2,April 2016,-144063682,34393418,178457100
Textiles & Fabrics,May,2016,Q2,May 2016,-176200559,30915132,207115691
Textiles & Fabrics,June,2016,Q2,June 2016,-177996443,31526530,209522973
Textiles & Fabrics,July,2016,Q3,July 2016,-174998736,39108611,214107347
Textiles & Fabrics,August,2016,Q3,August 2016,-175133001,37536978,212669979
Textiles & Fabrics,September,2016,Q3,September 2016,-142750435,37851011,180601446
Textiles & Fabrics,October,2016,Q4,October 2016,-148607540,33880222,182487762
Textiles & Fabrics,November,2016,Q4,November 2016,-152800418,38294165,191094583
Textiles & Fabrics,December,2016,Q4,December 2016,-158100118,36431342,194531460
Textiles & Fabrics,January,2017,Q1,January 2017,-188735252,29044761,217780013
Textiles & Fabrics,February,2017,Q1,February 2017,-136163269,31571082,167734351
Textiles & Fabrics,March,2017,Q1,March 2017,-104344804,35425066,139769870
Textiles & Fabrics,April,2017,Q2,April 2017,-149656117,32931765,182587882
Textiles & Fabrics,May,2017,Q2,May 2017,-169079844,36368478,205448322
Textiles & Fabrics,June,2017,Q2,June 2017,-174057115,32397890,206455005
Textiles & Fabrics,July,2017,Q3,July 2017,-176218436,34322244,210540680
Textiles & Fabrics,August,2017,Q3,August 2017,-152132382,41115634,193248016
Textiles & Fabrics,September,2017,Q3,September 2017,-151428290,37572502,189000792
Textiles & Fabrics,October,2017,Q4,October 2017,-146116988,40385431,186502419
Textiles & Fabrics,November,2017,Q4,November 2017,-141213082,38184250,179397332
Textiles & Fabrics,December,2017,Q4,December 2017,-156369174,38783955,195153129
Textiles & Fabrics,January,2018,Q1,January 2018,-189413741,29164507,218578248
Textiles & Fabrics,February,2018,Q1,February 2018,-172894040,31338946,204232986
Textiles & Fabrics,March,2018,Q1,March 2018,-117353675,34918344,152272019
Textiles & Fabrics,April,2018,Q2,April 2018,-128795648,31540132,160335780
Textiles & Fabrics,May,2018,Q2,May 2018,-183631973,32519971,216151944
Textiles & Fabrics,June,2018,Q2,June 2018,-201437799,31908581,233346380
Textiles & Fabrics,July,2018,Q3,July 2018,-212967790,34531423,247499213
Textiles & Fabrics,August,2018,Q3,August 2018,-210121731,30844480,240966211
Textiles & Fabrics,September,2018,Q3,September 2018,-170074031,29983159,200057190
Textiles & Fabrics,October,2018,Q4,October 2018,-178562317,33340000,211902317
Textiles & Fabrics,November,2018,Q4,November 2018,-184854917,29255750,214110667
Textiles & Fabrics,December,2018,Q4,December 2018,-225232389,28828282,254060671
Textiles & Fabrics,January,2019,Q1,January 2019,-163512642,22847055,186359697
Textiles & Fabrics,February,2019,Q1,February 2019,-125327536,26628849,151956385
Textiles & Fabrics,March,2019,Q1,March 2019,-83011834,29971217,112983051
Textiles & Fabrics,April,2019,Q2,April 2019,-132060629,25837126,157897755
Textiles & Fabrics,May,2019,Q2,May 2019,-148114027,28255038,176369065
Textiles & Fabrics,June,2019,Q2,June 2019,-127035974,25530835,152566809
Textiles & Fabrics,July,2019,Q3,July 2019,-136257013,24369586,160626599
Textiles & Fabrics,August,2019,Q3,August 2019,-135249671,24860541,160110212
Textiles & Fabrics,September,2019,Q3,September 2019,-112719864,24613341,137333205
Textiles & Fabrics,October,2019,Q4,October 2019,-109210630,27657304,136867934
Textiles & Fabrics,November,2019,Q4,November 2019,-105771563,21198620,126970183
Textiles & Fabrics,December,2019,Q4,December 2019,-118814337,21952672,140767009
Textile Mill Products,January,2002,Q1,January 2002,-172029941,669334,172699275
Textile Mill Products,February,2002,Q1,February 2002,-154683351,1160717,155844068
Textile Mill Products,March,2002,Q1,March 2002,-140813762,1053454,141867216
Textile Mill Products,April,2002,Q2,April 2002,-195297233,1029865,196327098
Textile Mill Products,May,2002,Q2,May 2002,-216567433,860052,217427485
Textile Mill Products,June,2002,Q2,June 2002,-224554036,1083896,225637932
Textile Mill Products,July,2002,Q3,July 2002,-228152650,1798925,229951575
Textile Mill Products,August,2002,Q3,August 2002,-262955106,1089757,264044863
Textile Mill Products,September,2002,Q3,September 2002,-228017558,1427610,229445168
Textile Mill Products,October,2002,Q4,October 2002,-196636083,768672,197404755
Textile Mill Products,November,2002,Q4,November 2002,-196704572,1517412,198221984
Textile Mill Products,December,2002,Q4,December 2002,-216663795,1021384,217685179
Textile Mill Products,January,2003,Q1,January 2003,-249064322,1627812,250692134
Textile Mill Products,February,2003,Q1,February 2003,-236497863,2573073,239070936
Textile Mill Products,March,2003,Q1,March 2003,-213915061,2233204,216148265
Textile Mill Products,April,2003,Q2,April 2003,-265975029,1354033,267329062
Textile Mill Products,May,2003,Q2,May 2003,-280577505,2558789,283136294
Textile Mill Products,June,2003,Q2,June 2003,-278273318,2831478,281104796
Textile Mill Products,July,2003,Q3,July 2003,-310949698,1567663,312517361
Textile Mill Products,August,2003,Q3,August 2003,-299540550,1200316,300740866
Textile Mill Products,September,2003,Q3,September 2003,-312287192,1176930,313464122
Textile Mill Products,October,2003,Q4,October 2003,-327262327,1512701,328775028
Textile Mill Products,November,2003,Q4,November 2003,-263146746,1466806,264613552
Textile Mill Products,December,2003,Q4,December 2003,-282356431,1214892,283571323
Textile Mill Products,January,2004,Q1,January 2004,-350317367,1894378,352211745
Textile Mill Products,February,2004,Q1,February 2004,-239707313,1831534,241538847
Textile Mill Products,March,2004,Q1,March 2004,-298538801,1922682,300461483
Textile Mill Products,April,2004,Q2,April 2004,-357963227,1459825,359423052
Textile Mill Products,May,2004,Q2,May 2004,-375701350,2736298,378437648
Textile Mill Products,June,2004,Q2,June 2004,-409827708,1597485,411425193
Textile Mill Products,July,2004,Q3,July 2004,-396509933,1423664,397933597
Textile Mill Products,August,2004,Q3,August 2004,-398655113,2512972,401168085
Textile Mill Products,September,2004,Q3,September 2004,-398043914,1504344,399548258
Textile Mill Products,October,2004,Q4,October 2004,-416846391,1396202,418242593
Textile Mill Products,November,2004,Q4,November 2004,-389220727,1800197,391020924
Textile Mill Products,December,2004,Q4,December 2004,-368025897,2071479,370097376
Textile Mill Products,January,2005,Q1,January 2005,-423125732,1723723,424849455
Textile Mill Products,February,2005,Q1,February 2005,-442403024,2344539,444747563
Textile Mill Products,March,2005,Q1,March 2005,-368340823,2697207,371038030
Textile Mill Products,April,2005,Q2,April 2005,-436469732,2213701,438683433
Textile Mill Products,May,2005,Q2,May 2005,-466936981,2467240,469404221
Textile Mill Products,June,2005,Q2,June 2005,-479993132,2666261,482659393
Textile Mill Products,July,2005,Q3,July 2005,-464716434,2091566,466808000
Textile Mill Products,August,2005,Q3,August 2005,-573800350,3392078,577192428
Textile Mill Products,September,2005,Q3,September 2005,-560403270,2619759,563023029
Textile Mill Products,October,2005,Q4,October 2005,-549135505,2437239,551572744
Textile Mill Products,November,2005,Q4,November 2005,-469016277,2642962,471659239
Textile Mill Products,December,2005,Q4,December 2005,-432153378,3200330,435353708
Textile Mill Products,January,2006,Q1,January 2006,-542776680,2187359,544964039
Textile Mill Products,February,2006,Q1,February 2006,-441364730,4332119,445696849
Textile Mill Products,March,2006,Q1,March 2006,-423882745,4057141,427939886
Textile Mill Products,April,2006,Q2,April 2006,-530252699,3781502,534034201
Textile Mill Products,May,2006,Q2,May 2006,-570501409,4689559,575190968
Textile Mill Products,June,2006,Q2,June 2006,-560939579,3099382,564038961
Textile Mill Products,July,2006,Q3,July 2006,-562788170,3479736,566267906
Textile Mill Products,August,2006,Q3,August 2006,-642421944,2494517,644916461
Textile Mill Products,September,2006,Q3,September 2006,-604937039,3333901,608270940
Textile Mill Products,October,2006,Q4,October 2006,-591229059,4359592,595588651
Textile Mill Products,November,2006,Q4,November 2006,-542384852,4387641,546772493
Textile Mill Products,December,2006,Q4,December 2006,-524827477,5683804,530511281
Textile Mill Products,January,2007,Q1,January 2007,-589264051,12031063,601295114
Textile Mill Products,February,2007,Q1,February 2007,-544858392,3876673,548735065
Textile Mill Products,March,2007,Q1,March 2007,-464017751,4691523,468709274
Textile Mill Products,April,2007,Q2,April 2007,-538586758,3116721,541703479
Textile Mill Products,May,2007,Q2,May 2007,-640997392,4220278,645217670
Textile Mill Products,June,2007,Q2,June 2007,-633484130,3754975,637239105
Textile Mill Products,July,2007,Q3,July 2007,-685770388,7882496,693652884
Textile Mill Products,August,2007,Q3,August 2007,-670324144,4160860,674485004
Textile Mill Products,September,2007,Q3,September 2007,-659719930,1863612,661583542
Textile Mill Products,October,2007,Q4,October 2007,-675827158,1921901,677749059
Textile Mill Products,November,2007,Q4,November 2007,-616425148,2481843,618906991
Textile Mill Products,December,2007,Q4,December 2007,-572168475,4631515,576799990
Textile Mill Products,January,2008,Q1,January 2008,-648144664,3820543,651965207
Textile Mill Products,February,2008,Q1,February 2008,-619895165,3347851,623243016
Textile Mill Products,March,2008,Q1,March 2008,-432869575,6787767,439657342
Textile Mill Products,April,2008,Q2,April 2008,-583579247,5116206,588695453
Textile Mill Products,May,2008,Q2,May 2008,-659278053,6472927,665750980
Textile Mill Products,June,2008,Q2,June 2008,-612862688,6602598,619465286
Textile Mill Products,July,2008,Q3,July 2008,-655896419,7149565,663045984
Textile Mill Products,August,2008,Q3,August 2008,-681720970,5313311,687034281
Textile Mill Products,September,2008,Q3,September 2008,-663119538,4334216,667453754
Textile Mill Products,October,2008,Q4,October 2008,-645606247,6189115,651795362
Textile Mill Products,November,2008,Q4,November 2008,-541557923,4964050,546521973
Textile Mill Products,December,2008,Q4,December 2008,-512956005,3811978,516767983
Textile Mill Products,January,2009,Q1,January 2009,-583532286,3342708,586874994
Textile Mill Products,February,2009,Q1,February 2009,-450709607,4192872,454902479
Textile Mill Products,March,2009,Q1,March 2009,-448795156,3417397,452212553
Textile Mill Products,April,2009,Q2,April 2009,-527284572,2537117,529821689
Textile Mill Products,May,2009,Q2,May 2009,-567761985,4833503,572595488
Textile Mill Products,June,2009,Q2,June 2009,-548590868,2998490,551589358
Textile Mill Products,July,2009,Q3,July 2009,-577312936,4385972,581698908
Textile Mill Products,August,2009,Q3,August 2009,-592422767,4300449,596723216
Textile Mill Products,September,2009,Q3,September 2009,-586532762,3979472,590512234
Textile Mill Products,October,2009,Q4,October 2009,-603459504,3651541,607111045
Textile Mill Products,November,2009,Q4,November 2009,-528215889,3954966,532170855
Textile Mill Products,December,2009,Q4,December 2009,-558524333,4198981,562723314
Textile Mill Products,January,2010,Q1,January 2010,-598025858,3994934,602020792
Textile Mill Products,February,2010,Q1,February 2010,-542674015,5216372,547890387
Textile Mill Products,March,2010,Q1,March 2010,-522120953,4448048,526569001
Textile Mill Products,April,2010,Q2,April 2010,-566208963,3144258,569353221
Textile Mill Products,May,2010,Q2,May 2010,-724355511,4655659,729011170
Textile Mill Products,June,2010,Q2,June 2010,-787983977,5469551,793453528
Textile Mill Products,July,2010,Q3,July 2010,-775736248,3330116,779066364
Textile Mill Products,August,2010,Q3,August 2010,-831671427,3959779,835631206
Textile Mill Products,September,2010,Q3,September 2010,-783702234,3462121,787164355
Textile Mill Products,October,2010,Q4,October 2010,-748487914,5252139,753740053
Textile Mill Products,November,2010,Q4,November 2010,-677962029,4740261,682702290
Textile Mill Products,December,2010,Q4,December 2010,-619924925,4830634,624755559
Textile Mill Products,January,2011,Q1,January 2011,-692055819,3531100,695586919
Textile Mill Products,February,2011,Q1,February 2011,-658629604,3660455,662290059
Textile Mill Products,March,2011,Q1,March 2011,-496977649,6394017,503371666
Textile Mill Products,April,2011,Q2,April 2011,-665898631,5960649,671859280
Textile Mill Products,May,2011,Q2,May 2011,-788307001,7113923,795420924
Textile Mill Products,June,2011,Q2,June 2011,-778507637,6513375,785021012
Textile Mill Products,July,2011,Q3,July 2011,-796529646,6880036,803409682
Textile Mill Products,August,2011,Q3,August 2011,-852113127,5061168,857174295
Textile Mill Products,September,2011,Q3,September 2011,-818370121,5080704,823450825
Textile Mill Products,October,2011,Q4,October 2011,-798471280,3386594,801857874
Textile Mill Products,November,2011,Q4,November 2011,-758661764,4961511,763623275
Textile Mill Products,December,2011,Q4,December 2011,-631043859,3424284,634468143
Textile Mill Products,January,2012,Q1,January 2012,-841269573,3800774,845070347
Textile Mill Products,February,2012,Q1,February 2012,-638968708,4518420,643487128
Textile Mill Products,March,2012,Q1,March 2012,-631841125,3268014,635109139
Textile Mill Products,April,2012,Q2,April 2012,-781179746,3883712,785063458
Textile Mill Products,May,2012,Q2,May 2012,-888702278,5655352,894357630
Textile Mill Products,June,2012,Q2,June 2012,-874714161,4868222,879582383
Textile Mill Products,July,2012,Q3,July 2012,-890246297,6662968,896909265
Textile Mill Products,August,2012,Q3,August 2012,-873464990,5837091,879302081
Textile Mill Products,September,2012,Q3,September 2012,-848221475,6929336,855150811
Textile Mill Products,October,2012,Q4,October 2012,-875665435,5511890,881177325
Textile Mill Products,November,2012,Q4,November 2012,-758644426,4909325,763553751
Textile Mill Products,December,2012,Q4,December 2012,-741231901,3369979,744601880
Textile Mill Products,January,2013,Q1,January 2013,-839252086,3261136,842513222
Textile Mill Products,February,2013,Q1,February 2013,-832107991,4072071,836180062
Textile Mill Products,March,2013,Q1,March 2013,-533564262,6605840,540170102
Textile Mill Products,April,2013,Q2,April 2013,-775214339,5398588,780612927
Textile Mill Products,May,2013,Q2,May 2013,-897798049,5846528,903644577
Textile Mill Products,June,2013,Q2,June 2013,-892214932,3940280,896155212
Textile Mill Products,July,2013,Q3,July 2013,-913645572,4541421,918186993
Textile Mill Products,August,2013,Q3,August 2013,-978512059,6451116,984963175
Textile Mill Products,September,2013,Q3,September 2013,-935001857,4813038,939814895
Textile Mill Products,October,2013,Q4,October 2013,-920595653,4803876,925399529
Textile Mill Products,November,2013,Q4,November 2013,-839354030,4292125,843646155
Textile Mill Products,December,2013,Q4,December 2013,-788113684,4879861,792993545
Textile Mill Products,January,2014,Q1,January 2014,-919919918,5072668,924992586
Textile Mill Products,February,2014,Q1,February 2014,-764665225,5148116,769813341
Textile Mill Products,March,2014,Q1,March 2014,-602887087,4048594,606935681
Textile Mill Products,April,2014,Q2,April 2014,-794661629,5714177,800375806
Textile Mill Products,May,2014,Q2,May 2014,-908098604,6223617,914322221
Textile Mill Products,June,2014,Q2,June 2014,-927003976,3384559,930388535
Textile Mill Products,July,2014,Q3,July 2014,-933961295,4386330,938347625
Textile Mill Products,August,2014,Q3,August 2014,-961102761,4349220,965451981
Textile Mill Products,September,2014,Q3,September 2014,-980381321,4568183,984949504
Textile Mill Products,October,2014,Q4,October 2014,-997331600,5305947,1002637547
Textile Mill Products,November,2014,Q4,November 2014,-875340718,5948747,881289465
Textile Mill Products,December,2014,Q4,December 2014,-822193995,5537862,827731857
Textile Mill Products,January,2015,Q1,January 2015,-819968777,5211607,825180384
Textile Mill Products,February,2015,Q1,February 2015,-745527539,4871061,750398600
Textile Mill Products,March,2015,Q1,March 2015,-993891373,5850461,999741834
Textile Mill Products,April,2015,Q2,April 2015,-834462380,4827658,839290038
Textile Mill Products,May,2015,Q2,May 2015,-1046497945,4534083,1051032028
Textile Mill Products,June,2015,Q2,June 2015,-1014754123,5661613,1020415736
Textile Mill Products,July,2015,Q3,July 2015,-1025713730,4048761,1029762491
Textile Mill Products,August,2015,Q3,August 2015,-1124048709,6146249,1130194958
Textile Mill Products,September,2015,Q3,September 2015,-1026867489,4772220,1031639709
Textile Mill Products,October,2015,Q4,October 2015,-976628923,4732268,981361191
Textile Mill Products,November,2015,Q4,November 2015,-865243292,4401724,869645016
Textile Mill Products,December,2015,Q4,December 2015,-794574791,6325557,800900348
Textile Mill Products,January,2016,Q1,January 2016,-893467979,6907131,900375110
Textile Mill Products,February,2016,Q1,February 2016,-975432399,4780175,980212574
Textile Mill Products,March,2016,Q1,March 2016,-599718893,6204162,605923055
Textile Mill Products,April,2016,Q2,April 2016,-817978199,6107843,824086042
Textile Mill Products,May,2016,Q2,May 2016,-980525390,3638116,984163506
Textile Mill Products,June,2016,Q2,June 2016,-957912445,3819213,961731658
Textile Mill Products,July,2016,Q3,July 2016,-967862488,4860534,972723022
Textile Mill Products,August,2016,Q3,August 2016,-1076452003,6048305,1082500308
Textile Mill Products,September,2016,Q3,September 2016,-919915398,5335834,925251232
Textile Mill Products,October,2016,Q4,October 2016,-1038060016,6885582,1044945598
Textile Mill Products,November,2016,Q4,November 2016,-963810352,6566333,970376685
Textile Mill Products,December,2016,Q4,December 2016,-866384504,5732261,872116765
Textile Mill Products,January,2017,Q1,January 2017,-1021631390,4147920,1025779310
Textile Mill Products,February,2017,Q1,February 2017,-845129493,7365204,852494697
Textile Mill Products,March,2017,Q1,March 2017,-680840222,6416539,687256761
Textile Mill Products,April,2017,Q2,April 2017,-909436653,5899480,915336133
Textile Mill Products,May,2017,Q2,May 2017,-1038945229,5943684,1044888913
Textile Mill Products,June,2017,Q2,June 2017,-1023020249,6124501,1029144750
Textile Mill Products,July,2017,Q3,July 2017,-997031145,5312460,1002343605
Textile Mill Products,August,2017,Q3,August 2017,-1088447034,6794844,1095241878
Textile Mill Products,September,2017,Q3,September 2017,-1023828642,5884430,1029713072
Textile Mill Products,October,2017,Q4,October 2017,-1072649391,5727104,1078376495
Textile Mill Products,November,2017,Q4,November 2017,-998949896,6635517,1005585413
Textile Mill Products,December,2017,Q4,December 2017,-906830788,6709277,913540065
Textile Mill Products,January,2018,Q1,January 2018,-1014831431,4347203,1019178634
Textile Mill Products,February,2018,Q1,February 2018,-956204085,4373986,960578071
Textile Mill Products,March,2018,Q1,March 2018,-792568318,8617881,801186199
Textile Mill Products,April,2018,Q2,April 2018,-813078344,7227139,820305483
Textile Mill Products,May,2018,Q2,May 2018,-1048157933,6391241,1054549174
Textile Mill Products,June,2018,Q2,June 2018,-1137379521,5546817,1142926338
Textile Mill Products,July,2018,Q3,July 2018,-1152062026,6132466,1158194492
Textile Mill Products,August,2018,Q3,August 2018,-1106779441,5988311,1112767752
Textile Mill Products,September,2018,Q3,September 2018,-1125124541,5956738,1131081279
Textile Mill Products,October,2018,Q4,October 2018,-1320409398,7306098,1327715496
Textile Mill Products,November,2018,Q4,November 2018,-1094240491,8160519,1102401010
Textile Mill Products,December,2018,Q4,December 2018,-1057285427,4734505,1062019932
Textile Mill Products,January,2019,Q1,January 2019,-1177040960,4161242,1181202202
Textile Mill Products,February,2019,Q1,February 2019,-990579844,4953355,995533199
Textile Mill Products,March,2019,Q1,March 2019,-700795920,6597846,707393766
Textile Mill Products,April,2019,Q2,April 2019,-935413753,5961914,941375667
Textile Mill Products,May,2019,Q2,May 2019,-1164177240,6759061,1170936301
Textile Mill Products,June,2019,Q2,June 2019,-1078785114,6861366,1085646480
Textile Mill Products,July,2019,Q3,July 2019,-1227134947,9499589,1236634536
Textile Mill Products,August,2019,Q3,August 2019,-1198734761,7395776,1206130537
Textile Mill Products,September,2019,Q3,September 2019,-1121775904,7182868,1128958772
Textile Mill Products,October,2019,Q4,October 2019,-1109024474,5187000,1114211474
Textile Mill Products,November,2019,Q4,November 2019,-995697517,5239673,1000937190
Textile Mill Products,December,2019,Q4,December 2019,-899892721,5964485,905857206
Apparel & Accessories,January,2002,Q1,January 2002,-707013047,2756209,709769256
Apparel & Accessories,February,2002,Q1,February 2002,-549249777,3585682,552835459
Apparel & Accessories,March,2002,Q1,March 2002,-441837117,3592117,445429234
Apparel & Accessories,April,2002,Q2,April 2002,-549948833,2913474,552862307
Apparel & Accessories,May,2002,Q2,May 2002,-577748590,1008778,578757368
Apparel & Accessories,June,2002,Q2,June 2002,-769833162,1058759,770891921
Apparel & Accessories,July,2002,Q3,July 2002,-999612479,1145538,1000758017
Apparel & Accessories,August,2002,Q3,August 2002,-1162969437,1398310,1164367747
Apparel & Accessories,September,2002,Q3,September 2002,-1060544283,987662,1061531945
Apparel & Accessories,October,2002,Q4,October 2002,-889349386,1330710,890680096
Apparel & Accessories,November,2002,Q4,November 2002,-779781783,2128349,781910132
Apparel & Accessories,December,2002,Q4,December 2002,-763741580,1450151,765191731
Apparel & Accessories,January,2003,Q1,January 2003,-949941170,1211674,951152844
Apparel & Accessories,February,2003,Q1,February 2003,-768041530,1060150,769101680
Apparel & Accessories,March,2003,Q1,March 2003,-645084081,1458254,646542335
Apparel & Accessories,April,2003,Q2,April 2003,-723011647,1332992,724344639
Apparel & Accessories,May,2003,Q2,May 2003,-699381774,1676677,701058451
Apparel & Accessories,June,2003,Q2,June 2003,-909386623,816428,910203051
Apparel & Accessories,July,2003,Q3,July 2003,-1175573844,1451174,1177025018
Apparel & Accessories,August,2003,Q3,August 2003,-1218377251,2548678,1220925929
Apparel & Accessories,September,2003,Q3,September 2003,-1189094367,1369031,1190463398
Apparel & Accessories,October,2003,Q4,October 2003,-1138637586,1040515,1139678101
Apparel & Accessories,November,2003,Q4,November 2003,-771008472,991680,772000152
Apparel & Accessories,December,2003,Q4,December 2003,-836298865,1342769,837641634
Apparel & Accessories,January,2004,Q1,January 2004,-1049867280,2381731,1052249011
Apparel & Accessories,February,2004,Q1,February 2004,-688129142,2147651,690276793
Apparel & Accessories,March,2004,Q1,March 2004,-844513479,1745320,846258799
Apparel & Accessories,April,2004,Q2,April 2004,-842637703,1595124,844232827
Apparel & Accessories,May,2004,Q2,May 2004,-841836173,1331338,843167511
Apparel & Accessories,June,2004,Q2,June 2004,-1168628255,1832415,1170460670
Apparel & Accessories,July,2004,Q3,July 2004,-1376107203,2047623,1378154826
Apparel & Accessories,August,2004,Q3,August 2004,-1430727412,3007461,1433734873
Apparel & Accessories,September,2004,Q3,September 2004,-1521284947,2946599,1524231546
Apparel & Accessories,October,2004,Q4,October 2004,-1360634214,4586179,1365220393
Apparel & Accessories,November,2004,Q4,November 2004,-1069708760,1725266,1071434026
Apparel & Accessories,December,2004,Q4,December 2004,-923209903,2652911,925862814
Apparel & Accessories,January,2005,Q1,January 2005,-1400335726,3261383,1403597109
Apparel & Accessories,February,2005,Q1,February 2005,-1559270987,1902396,1561173383
Apparel & Accessories,March,2005,Q1,March 2005,-1190517897,2489731,1193007628
Apparel & Accessories,April,2005,Q2,April 2005,-1305213282,1362210,1306575492
Apparel & Accessories,May,2005,Q2,May 2005,-1497688124,1628661,1499316785
Apparel & Accessories,June,2005,Q2,June 2005,-2270363691,6059921,2276423612
Apparel & Accessories,July,2005,Q3,July 2005,-2107812390,3580028,2111392418
Apparel & Accessories,August,2005,Q3,August 2005,-2077986980,7464767,2085451747
Apparel & Accessories,September,2005,Q3,September 2005,-1954254002,3417422,1957671424
Apparel & Accessories,October,2005,Q4,October 2005,-1682990990,2659491,1685650481
Apparel & Accessories,November,2005,Q4,November 2005,-1188764584,3015052,1191779636
Apparel & Accessories,December,2005,Q4,December 2005,-1068498636,2634118,1071132754
Apparel & Accessories,January,2006,Q1,January 2006,-1460782027,2047276,1462829303
Apparel & Accessories,February,2006,Q1,February 2006,-1197741090,2161701,1199902791
Apparel & Accessories,March,2006,Q1,March 2006,-1127489123,2723841,1130212964
Apparel & Accessories,April,2006,Q2,April 2006,-1206257079,2006137,1208263216
Apparel & Accessories,May,2006,Q2,May 2006,-1377963505,1943299,1379906804
Apparel & Accessories,June,2006,Q2,June 2006,-1894462401,1368282,1895830683
Apparel & Accessories,July,2006,Q3,July 2006,-2249600467,2401723,2252002190
Apparel & Accessories,August,2006,Q3,August 2006,-2750979640,1677788,2752657428
Apparel & Accessories,September,2006,Q3,September 2006,-2747548177,1700566,2749248743
Apparel & Accessories,October,2006,Q4,October 2006,-2604439007,2752117,2607191124
Apparel & Accessories,November,2006,Q4,November 2006,-1935844294,1687062,1937531356
Apparel & Accessories,December,2006,Q4,December 2006,-1839828897,2409302,1842238199
Apparel & Accessories,January,2007,Q1,January 2007,-2336612363,2101620,2338713983
Apparel & Accessories,February,2007,Q1,February 2007,-1850584347,1959497,1852543844
Apparel & Accessories,March,2007,Q1,March 2007,-1481933176,3676560,1485609736
Apparel & Accessories,April,2007,Q2,April 2007,-1511497028,4294409,1515791437
Apparel & Accessories,May,2007,Q2,May 2007,-1791089966,1557482,1792647448
Apparel & Accessories,June,2007,Q2,June 2007,-2242972921,2303932,2245276853
Apparel & Accessories,July,2007,Q3,July 2007,-2793257024,1850355,2795107379
Apparel & Accessories,August,2007,Q3,August 2007,-3022858305,2699484,3025557789
Apparel & Accessories,September,2007,Q3,September 2007,-2964281553,2498769,2966780322
Apparel & Accessories,October,2007,Q4,October 2007,-2813507375,2637202,2816144577
Apparel & Accessories,November,2007,Q4,November 2007,-1949833019,2912059,1952745078
Apparel & Accessories,December,2007,Q4,December 2007,-1566667731,3839841,1570507572
Apparel & Accessories,January,2008,Q1,January 2008,-2054683365,4112685,2058796050
Apparel & Accessories,February,2008,Q1,February 2008,-1844635444,1632113,1846267557
Apparel & Accessories,March,2008,Q1,March 2008,-1219605443,2588238,1222193681
Apparel & Accessories,April,2008,Q2,April 2008,-1550732706,2564550,1553297256
Apparel & Accessories,May,2008,Q2,May 2008,-1751053928,3826005,1754879933
Apparel & Accessories,June,2008,Q2,June 2008,-2057335268,4428841,2061764109
Apparel & Accessories,July,2008,Q3,July 2008,-2736967815,5968732,2742936547
Apparel & Accessories,August,2008,Q3,August 2008,-2918038854,3516305,2921555159
Apparel & Accessories,September,2008,Q3,September 2008,-3192720300,2055433,3194775733
Apparel & Accessories,October,2008,Q4,October 2008,-3042505344,1959821,3044465165
Apparel & Accessories,November,2008,Q4,November 2008,-1956300211,2870612,1959170823
Apparel & Accessories,December,2008,Q4,December 2008,-1808079035,1703765,1809782800
Apparel & Accessories,January,2009,Q1,January 2009,-2171126009,2401000,2173527009
Apparel & Accessories,February,2009,Q1,February 2009,-1581111845,1715193,1582827038
Apparel & Accessories,March,2009,Q1,March 2009,-1409879440,2208824,1412088264
Apparel & Accessories,April,2009,Q2,April 2009,-1601205140,1476130,1602681270
Apparel & Accessories,May,2009,Q2,May 2009,-1686851709,3620972,1690472681
Apparel & Accessories,June,2009,Q2,June 2009,-2126951629,2617874,2129569503
Apparel & Accessories,July,2009,Q3,July 2009,-2726982742,3028046,2730010788
Apparel & Accessories,August,2009,Q3,August 2009,-2808010384,2234413,2810244797
Apparel & Accessories,September,2009,Q3,September 2009,-3066253778,2985752,3069239530
Apparel & Accessories,October,2009,Q4,October 2009,-2933938147,2039558,2935977705
Apparel & Accessories,November,2009,Q4,November 2009,-2045976955,3351396,2049328351
Apparel & Accessories,December,2009,Q4,December 2009,-1978166818,3779569,1981946387
Apparel & Accessories,January,2010,Q1,January 2010,-2199925709,1803804,2201729513
Apparel & Accessories,February,2010,Q1,February 2010,-2025298081,1402798,2026700879
Apparel & Accessories,March,2010,Q1,March 2010,-1618913653,2753281,1621666934
Apparel & Accessories,April,2010,Q2,April 2010,-1714523579,1647337,1716170916
Apparel & Accessories,May,2010,Q2,May 2010,-2040741975,2278586,2043020561
Apparel & Accessories,June,2010,Q2,June 2010,-2682515607,2801201,2685316808
Apparel & Accessories,July,2010,Q3,July 2010,-3287565782,2817923,3290383705
Apparel & Accessories,August,2010,Q3,August 2010,-3637330393,2392429,3639722822
Apparel & Accessories,September,2010,Q3,September 2010,-3593850545,1832969,3595683514
Apparel & Accessories,October,2010,Q4,October 2010,-3507269764,2409171,3509678935
Apparel & Accessories,November,2010,Q4,November 2010,-2508597688,2742330,2511340018
Apparel & Accessories,December,2010,Q4,December 2010,-2123547576,4330312,2127877888
Apparel & Accessories,January,2011,Q1,January 2011,-2666377841,2425867,2668803708
Apparel & Accessories,February,2011,Q1,February 2011,-2206282738,3172851,2209455589
Apparel & Accessories,March,2011,Q1,March 2011,-1406866700,3099482,1409966182
Apparel & Accessories,April,2011,Q2,April 2011,-1930704338,2923444,1933627782
Apparel & Accessories,May,2011,Q2,May 2011,-2287258503,3679285,2290937788
Apparel & Accessories,June,2011,Q2,June 2011,-2856858587,3272741,2860131328
Apparel & Accessories,July,2011,Q3,July 2011,-3524136194,3948329,3528084523
Apparel & Accessories,August,2011,Q3,August 2011,-3826413253,3188545,3829601798
Apparel & Accessories,September,2011,Q3,September 2011,-3771913832,3529148,3775442980
Apparel & Accessories,October,2011,Q4,October 2011,-3336803821,4743863,3341547684
Apparel & Accessories,November,2011,Q4,November 2011,-2445922503,2756194,2448678697
Apparel & Accessories,December,2011,Q4,December 2011,-2169658824,3657269,2173316093
Apparel & Accessories,January,2012,Q1,January 2012,-2871377852,2917703,2874295555
Apparel & Accessories,February,2012,Q1,February 2012,-1994025563,4554750,1998580313
Apparel & Accessories,March,2012,Q1,March 2012,-1583260904,3767400,1587028304
Apparel & Accessories,April,2012,Q2,April 2012,-2095370138,3423107,2098793245
Apparel & Accessories,May,2012,Q2,May 2012,-2100258835,3511112,2103769947
Apparel & Accessories,June,2012,Q2,June 2012,-2673392461,3587360,2676979821
Apparel & Accessories,July,2012,Q3,July 2012,-3524869026,4996126,3529865152
Apparel & Accessories,August,2012,Q3,August 2012,-3559265605,5808956,3565074561
Apparel & Accessories,September,2012,Q3,September 2012,-3555275233,5310706,3560585939
Apparel & Accessories,October,2012,Q4,October 2012,-3312242952,5357437,3317600389
Apparel & Accessories,November,2012,Q4,November 2012,-2328617286,4250951,2332868237
Apparel & Accessories,December,2012,Q4,December 2012,-2274689480,6135878,2280825358
Apparel & Accessories,January,2013,Q1,January 2013,-2791017391,4535301,2795552692
Apparel & Accessories,February,2013,Q1,February 2013,-2560242031,4798533,2565040564
Apparel & Accessories,March,2013,Q1,March 2013,-1467934349,4001723,1471936072
Apparel & Accessories,April,2013,Q2,April 2013,-1967519897,3555446,1971075343
Apparel & Accessories,May,2013,Q2,May 2013,-2178659666,4204059,2182863725
Apparel & Accessories,June,2013,Q2,June 2013,-2612265429,4543711,2616809140
Apparel & Accessories,July,2013,Q3,July 2013,-3639536037,5504692,3645040729
Apparel & Accessories,August,2013,Q3,August 2013,-3732124677,5424635,3737549312
Apparel & Accessories,September,2013,Q3,September 2013,-3599400349,4520994,3603921343
Apparel & Accessories,October,2013,Q4,October 2013,-3366856660,4329042,3371185702
Apparel & Accessories,November,2013,Q4,November 2013,-2446774855,4891899,2451666754
Apparel & Accessories,December,2013,Q4,December 2013,-2300494866,3588949,2304083815
Apparel & Accessories,January,2014,Q1,January 2014,-2918669157,3779152,2922448309
Apparel & Accessories,February,2014,Q1,February 2014,-2258387040,4654566,2263041606
Apparel & Accessories,March,2014,Q1,March 2014,-1632689393,4522065,1637211458
Apparel & Accessories,April,2014,Q2,April 2014,-1982872439,5021826,1987894265
Apparel & Accessories,May,2014,Q2,May 2014,-2127371925,3614343,2130986268
Apparel & Accessories,June,2014,Q2,June 2014,-2792202957,5607404,2797810361
Apparel & Accessories,July,2014,Q3,July 2014,-3527606339,5741009,3533347348
Apparel & Accessories,August,2014,Q3,August 2014,-3657566197,7222890,3664789087
Apparel & Accessories,September,2014,Q3,September 2014,-3772614288,6031303,3778645591
Apparel & Accessories,October,2014,Q4,October 2014,-3477639264,6368383,3484007647
Apparel & Accessories,November,2014,Q4,November 2014,-2335300523,7626372,2342926895
Apparel & Accessories,December,2014,Q4,December 2014,-2247655766,4989930,2252645696
Apparel & Accessories,January,2015,Q1,January 2015,-2613382716,5791139,2619173855
Apparel & Accessories,February,2015,Q1,February 2015,-2244564683,4562952,2249127635
Apparel & Accessories,March,2015,Q1,March 2015,-2281916604,7672914,2289589518
Apparel & Accessories,April,2015,Q2,April 2015,-1756561260,6451003,1763012263
Apparel & Accessories,May,2015,Q2,May 2015,-2121512031,7884315,2129396346
Apparel & Accessories,June,2015,Q2,June 2015,-2915555477,5858732,2921414209
Apparel & Accessories,July,2015,Q3,July 2015,-3675770920,6505856,3682276776
Apparel & Accessories,August,2015,Q3,August 2015,-4179208002,5869670,4185077672
Apparel & Accessories,September,2015,Q3,September 2015,-3708388492,5701431,3714089923
Apparel & Accessories,October,2015,Q4,October 2015,-3184964022,6154744,3191118766
Apparel & Accessories,November,2015,Q4,November 2015,-2361238679,6672307,2367910986
Apparel & Accessories,December,2015,Q4,December 2015,-2323841453,8805800,2332647253
Apparel & Accessories,January,2016,Q1,January 2016,-2661500164,5746458,2667246622
Apparel & Accessories,February,2016,Q1,February 2016,-2567039466,4741025,2571780491
Apparel & Accessories,March,2016,Q1,March 2016,-1420156291,9220078,1429376369
Apparel & Accessories,April,2016,Q2,April 2016,-1754288794,6798267,1761087061
Apparel & Accessories,May,2016,Q2,May 2016,-2039973765,6348821,2046322586
Apparel & Accessories,June,2016,Q2,June 2016,-2576058529,5344517,2581403046
Apparel & Accessories,July,2016,Q3,July 2016,-3242480723,6651074,3249131797
Apparel & Accessories,August,2016,Q3,August 2016,-3619814813,4632874,3624447687
Apparel & Accessories,September,2016,Q3,September 2016,-3152223003,4854280,3157077283
Apparel & Accessories,October,2016,Q4,October 2016,-2993476784,5245503,2998722287
Apparel & Accessories,November,2016,Q4,November 2016,-2150524516,8086472,2158610988
Apparel & Accessories,December,2016,Q4,December 2016,-2066562722,5762136,2072324858
Apparel & Accessories,January,2017,Q1,January 2017,-2749318672,3467764,2752786436
Apparel & Accessories,February,2017,Q1,February 2017,-2014199846,5833184,2020033030
Apparel & Accessories,March,2017,Q1,March 2017,-1490776038,9498498,1500274536
Apparel & Accessories,April,2017,Q2,April 2017,-1825097324,6680845,1831778169
Apparel & Accessories,May,2017,Q2,May 2017,-2029151432,8062516,2037213948
Apparel & Accessories,June,2017,Q2,June 2017,-2393227200,8947074,2402174274
Apparel & Accessories,July,2017,Q3,July 2017,-3052507794,7367410,3059875204
Apparel & Accessories,August,2017,Q3,August 2017,-3385682376,10429718,3396112094
Apparel & Accessories,September,2017,Q3,September 2017,-3161701784,8680296,3170382080
Apparel & Accessories,October,2017,Q4,October 2017,-2935178586,9241886,2944420472
Apparel & Accessories,November,2017,Q4,November 2017,-2226765225,8592247,2235357472
Apparel & Accessories,December,2017,Q4,December 2017,-1978361542,7481114,1985842656
Apparel & Accessories,January,2018,Q1,January 2018,-2553276680,7180243,2560456923
Apparel & Accessories,February,2018,Q1,February 2018,-2247255800,5489611,2252745411
Apparel & Accessories,March,2018,Q1,March 2018,-1514356574,9831678,1524188252
Apparel & Accessories,April,2018,Q2,April 2018,-1604775783,10643885,1615419668
Apparel & Accessories,May,2018,Q2,May 2018,-1964316115,13847262,1978163377
Apparel & Accessories,June,2018,Q2,June 2018,-2397781904,8380348,2406162252
Apparel & Accessories,July,2018,Q3,July 2018,-3156314619,14740479,3171055098
Apparel & Accessories,August,2018,Q3,August 2018,-3303181478,15879535,3319061013
Apparel & Accessories,September,2018,Q3,September 2018,-3343703378,14530811,3358234189
Apparel & Accessories,October,2018,Q4,October 2018,-3328753046,19530648,3348283694
Apparel & Accessories,November,2018,Q4,November 2018,-2164017504,14057659,2178075163
Apparel & Accessories,December,2018,Q4,December 2018,-2115058027,10396064,2125454091
Apparel & Accessories,January,2019,Q1,January 2019,-2738268800,8471303,2746740103
Apparel & Accessories,February,2019,Q1,February 2019,-2171094938,8188209,2179283147
Apparel & Accessories,March,2019,Q1,March 2019,-1300964844,11795668,1312760512
Apparel & Accessories,April,2019,Q2,April 2019,-1642732392,11974035,1654706427
Apparel & Accessories,May,2019,Q2,May 2019,-1979336054,13103558,1992439612
Apparel & Accessories,June,2019,Q2,June 2019,-2414995644,9978546,2424974190
Apparel & Accessories,July,2019,Q3,July 2019,-3371166279,13513856,3384680135
Apparel & Accessories,August,2019,Q3,August 2019,-3286084129,12804431,3298888560
Apparel & Accessories,September,2019,Q3,September 2019,-2718474167,10876472,2729350639
Apparel & Accessories,October,2019,Q4,October 2019,-2179660504,12309457,2191969961
Apparel & Accessories,November,2019,Q4,November 2019,-1518765849,10811899,1529577748
Apparel & Accessories,December,2019,Q4,December 2019,-1499604081,11716409,1511320490
Leather & Allied Products,January,2002,Q1,January 2002,-1025772658,3800720,1029573378
Leather & Allied Products,February,2002,Q1,February 2002,-996128034,6025230,1002153264
Leather & Allied Products,March,2002,Q1,March 2002,-768939206,10445841,779385047
Leather & Allied Products,April,2002,Q2,April 2002,-909476079,9270350,918746429
Leather & Allied Products,May,2002,Q2,May 2002,-1115112317,8797008,1123909325
Leather & Allied Products,June,2002,Q2,June 2002,-1281489673,8355749,1289845422
Leather & Allied Products,July,2002,Q3,July 2002,-1260589507,7503961,1268093468
Leather & Allied Products,August,2002,Q3,August 2002,-1307660472,8081750,1315742222
Leather & Allied Products,September,2002,Q3,September 2002,-1124417832,5211804,1129629636
Leather & Allied Products,October,2002,Q4,October 2002,-1006692517,6856630,1013549147
Leather & Allied Products,November,2002,Q4,November 2002,-1101196599,7707923,1108904522
Leather & Allied Products,December,2002,Q4,December 2002,-1071457437,8385069,1079842506
Leather & Allied Products,January,2003,Q1,January 2003,-1255847900,7062862,1262910762
Leather & Allied Products,February,2003,Q1,February 2003,-1106782741,8759901,1115542642
Leather & Allied Products,March,2003,Q1,March 2003,-1020556615,9707590,1030264205
Leather & Allied Products,April,2003,Q2,April 2003,-1040059334,11331367,1051390701
Leather & Allied Products,May,2003,Q2,May 2003,-1213211524,9009189,1222220713
Leather & Allied Products,June,2003,Q2,June 2003,-1326017563,9458590,1335476153
Leather & Allied Products,July,2003,Q3,July 2003,-1336858965,10598958,1347457923
Leather & Allied Products,August,2003,Q3,August 2003,-1279309176,8915252,1288224428
Leather & Allied Products,September,2003,Q3,September 2003,-1118473986,7541785,1126015771
Leather & Allied Products,October,2003,Q4,October 2003,-1178139168,11525521,1189664689
Leather & Allied Products,November,2003,Q4,November 2003,-1021332613,10090974,1031423587
Leather & Allied Products,December,2003,Q4,December 2003,-982161537,12694743,994856280
Leather & Allied Products,January,2004,Q1,January 2004,-1346078700,8734550,1354813250
Leather & Allied Products,February,2004,Q1,February 2004,-1076520757,10377643,1086898400
Leather & Allied Products,March,2004,Q1,March 2004,-1114004082,12475407,1126479489
Leather & Allied Products,April,2004,Q2,April 2004,-1114160561,14407732,1128568293
Leather & Allied Products,May,2004,Q2,May 2004,-1290798780,13174129,1303972909
Leather & Allied Products,June,2004,Q2,June 2004,-1474316361,12939100,1487255461
Leather & Allied Products,July,2004,Q3,July 2004,-1578257875,11808590,1590066465
Leather & Allied Products,August,2004,Q3,August 2004,-1410988832,13350374,1424339206
Leather & Allied Products,September,2004,Q3,September 2004,-1340440410,9943046,1350383456
Leather & Allied Products,October,2004,Q4,October 2004,-1266110567,10248425,1276358992
Leather & Allied Products,November,2004,Q4,November 2004,-1242329685,12960120,1255289805
Leather & Allied Products,December,2004,Q4,December 2004,-1145169638,12218530,1157388168
Leather & Allied Products,January,2005,Q1,January 2005,-1488547268,8849276,1497396544
Leather & Allied Products,February,2005,Q1,February 2005,-1391923097,7511899,1399434996
Leather & Allied Products,March,2005,Q1,March 2005,-1144411656,11226224,1155637880
Leather & Allied Products,April,2005,Q2,April 2005,-1270039579,8896337,1278935916
Leather & Allied Products,May,2005,Q2,May 2005,-1417485451,13207776,1430693227
Leather & Allied Products,June,2005,Q2,June 2005,-1653254014,10841482,1664095496
Leather & Allied Products,July,2005,Q3,July 2005,-1684329947,9278439,1693608386
Leather & Allied Products,August,2005,Q3,August 2005,-1628954102,13817624,1642771726
Leather & Allied Products,September,2005,Q3,September 2005,-1517292557,12624134,1529916691
Leather & Allied Products,October,2005,Q4,October 2005,-1513031736,16290660,1529322396
Leather & Allied Products,November,2005,Q4,November 2005,-1307965353,14375045,1322340398
Leather & Allied Products,December,2005,Q4,December 2005,-1342081441,15214454,1357295895
Leather & Allied Products,January,2006,Q1,January 2006,-1580327068,11053708,1591380776
Leather & Allied Products,February,2006,Q1,February 2006,-1372776483,13880943,1386657426
Leather & Allied Products,March,2006,Q1,March 2006,-1381573978,16482297,1398056275
Leather & Allied Products,April,2006,Q2,April 2006,-1442310492,16806762,1459117254
Leather & Allied Products,May,2006,Q2,May 2006,-1556400300,14732878,1571133178
Leather & Allied Products,June,2006,Q2,June 2006,-1764010034,15245268,1779255302
Leather & Allied Products,July,2006,Q3,July 2006,-1754855737,15968211,1770823948
Leather & Allied Products,August,2006,Q3,August 2006,-1794032476,18938499,1812970975
Leather & Allied Products,September,2006,Q3,September 2006,-1740888267,14237519,1755125786
Leather & Allied Products,October,2006,Q4,October 2006,-1721999549,16438849,1738438398
Leather & Allied Products,November,2006,Q4,November 2006,-1509417003,21276473,1530693476
Leather & Allied Products,December,2006,Q4,December 2006,-1411491238,20960965,1432452203
Leather & Allied Products,January,2007,Q1,January 2007,-1721310084,21241751,1742551835
Leather & Allied Products,February,2007,Q1,February 2007,-1633820563,23904804,1657725367
Leather & Allied Products,March,2007,Q1,March 2007,-1385776939,25790250,1411567189
Leather & Allied Products,April,2007,Q2,April 2007,-1415307203,20792382,1436099585
Leather & Allied Products,May,2007,Q2,May 2007,-1615485769,23229983,1638715752
Leather & Allied Products,June,2007,Q2,June 2007,-1832117032,17710415,1849827447
Leather & Allied Products,July,2007,Q3,July 2007,-1951582492,15127481,1966709973
Leather & Allied Products,August,2007,Q3,August 2007,-1872612252,20442516,1893054768
Leather & Allied Products,September,2007,Q3,September 2007,-1759569147,19119469,1778688616
Leather & Allied Products,October,2007,Q4,October 2007,-1681833432,18424872,1700258304
Leather & Allied Products,November,2007,Q4,November 2007,-1495712445,18124070,1513836515
Leather & Allied Products,December,2007,Q4,December 2007,-1387709523,15876086,1403585609
Leather & Allied Products,January,2008,Q1,January 2008,-1685288571,10638499,1695927070
Leather & Allied Products,February,2008,Q1,February 2008,-1731131927,18004105,1749136032
Leather & Allied Products,March,2008,Q1,March 2008,-1324726798,18322961,1343049759
Leather & Allied Products,April,2008,Q2,April 2008,-1468760920,22065100,1490826020
Leather & Allied Products,May,2008,Q2,May 2008,-1663426735,22923271,1686350006
Leather & Allied Products,June,2008,Q2,June 2008,-1756728998,22857714,1779586712
Leather & Allied Products,July,2008,Q3,July 2008,-1947090553,18122212,1965212765
Leather & Allied Products,August,2008,Q3,August 2008,-2037530571,20934977,2058465548
Leather & Allied Products,September,2008,Q3,September 2008,-1958017531,19282624,1977300155
Leather & Allied Products,October,2008,Q4,October 2008,-1920025237,16402718,1936427955
Leather & Allied Products,November,2008,Q4,November 2008,-1486786167,10561877,1497348044
Leather & Allied Products,December,2008,Q4,December 2008,-1414790338,11095735,1425886073
Leather & Allied Products,January,2009,Q1,January 2009,-1883346262,10804305,1894150567
Leather & Allied Products,February,2009,Q1,February 2009,-1396038259,14520735,1410558994
Leather & Allied Products,March,2009,Q1,March 2009,-1272289166,18162281,1290451447
Leather & Allied Products,April,2009,Q2,April 2009,-1250660998,18535735,1269196733
Leather & Allied Products,May,2009,Q2,May 2009,-1455643163,16456381,1472099544
Leather & Allied Products,June,2009,Q2,June 2009,-1521759341,17338497,1539097838
Leather & Allied Products,July,2009,Q3,July 2009,-1708651513,16861755,1725513268
Leather & Allied Products,August,2009,Q3,August 2009,-1674826723,19082920,1693909643
Leather & Allied Products,September,2009,Q3,September 2009,-1634957706,16455314,1651413020
Leather & Allied Products,October,2009,Q4,October 2009,-1632822402,26048246,1658870648
Leather & Allied Products,November,2009,Q4,November 2009,-1339143074,21288758,1360431832
Leather & Allied Products,December,2009,Q4,December 2009,-1386896990,19752821,1406649811
Leather & Allied Products,January,2010,Q1,January 2010,-1655591701,20877833,1676469534
Leather & Allied Products,February,2010,Q1,February 2010,-1657520447,23427964,1680948411
Leather & Allied Products,March,2010,Q1,March 2010,-1358110314,30388483,1388498797
Leather & Allied Products,April,2010,Q2,April 2010,-1452270610,27239588,1479510198
Leather & Allied Products,May,2010,Q2,May 2010,-1678473080,23446730,1701919810
Leather & Allied Products,June,2010,Q2,June 2010,-1994158212,20370211,2014528423
Leather & Allied Products,July,2010,Q3,July 2010,-2162196795,25642557,2187839352
Leather & Allied Products,August,2010,Q3,August 2010,-2345933627,21449877,2367383504
Leather & Allied Products,September,2010,Q3,September 2010,-2221283531,24579594,2245863125
Leather & Allied Products,October,2010,Q4,October 2010,-2096491129,27505629,2123996758
Leather & Allied Products,November,2010,Q4,November 2010,-1817980941,24349032,1842329973
Leather & Allied Products,December,2010,Q4,December 2010,-1595524797,27670254,1623195051
Leather & Allied Products,January,2011,Q1,January 2011,-2126531586,28293481,2154825067
Leather & Allied Products,February,2011,Q1,February 2011,-1901336033,20159490,1921495523
Leather & Allied Products,March,2011,Q1,March 2011,-1425314135,26162845,1451476980
Leather & Allied Products,April,2011,Q2,April 2011,-1642037040,29995555,1672032595
Leather & Allied Products,May,2011,Q2,May 2011,-1943997565,29138101,1973135666
Leather & Allied Products,June,2011,Q2,June 2011,-2076599844,32839355,2109439199
Leather & Allied Products,July,2011,Q3,July 2011,-2345210829,36336682,2381547511
Leather & Allied Products,August,2011,Q3,August 2011,-2441735357,27240449,2468975806
Leather & Allied Products,September,2011,Q3,September 2011,-2220465291,25465233,2245930524
Leather & Allied Products,October,2011,Q4,October 2011,-2024933598,27981493,2052915091
Leather & Allied Products,November,2011,Q4,November 2011,-1707442472,29800541,1737243013
Leather & Allied Products,December,2011,Q4,December 2011,-1589424108,23875306,1613299414
Leather & Allied Products,January,2012,Q1,January 2012,-2204085359,29424884,2233510243
Leather & Allied Products,February,2012,Q1,February 2012,-1682522099,24761957,1707284056
Leather & Allied Products,March,2012,Q1,March 2012,-1496105793,35724587,1531830380
Leather & Allied Products,April,2012,Q2,April 2012,-1800752609,29015436,1829768045
Leather & Allied Products,May,2012,Q2,May 2012,-1830920269,30270332,1861190601
Leather & Allied Products,June,2012,Q2,June 2012,-2066526854,24340241,2090867095
Leather & Allied Products,July,2012,Q3,July 2012,-2441228257,22797223,2464025480
Leather & Allied Products,August,2012,Q3,August 2012,-2323070015,24265552,2347335567
Leather & Allied Products,September,2012,Q3,September 2012,-2191311680,26501560,2217813240
Leather & Allied Products,October,2012,Q4,October 2012,-2156491213,30349691,2186840904
Leather & Allied Products,November,2012,Q4,November 2012,-1645834498,27607291,1673441789
Leather & Allied Products,December,2012,Q4,December 2012,-1730246911,31900843,1762147754
Leather & Allied Products,January,2013,Q1,January 2013,-2323434362,28329872,2351764234
Leather & Allied Products,February,2013,Q1,February 2013,-2150861400,37145891,2188007291
Leather & Allied Products,March,2013,Q1,March 2013,-1280214636,38715396,1318930032
Leather & Allied Products,April,2013,Q2,April 2013,-1660738459,33713801,1694452260
Leather & Allied Products,May,2013,Q2,May 2013,-1743912947,35178368,1779091315
Leather & Allied Products,June,2013,Q2,June 2013,-2031627034,34237428,2065864462
Leather & Allied Products,July,2013,Q3,July 2013,-2435678496,28822294,2464500790
Leather & Allied Products,August,2013,Q3,August 2013,-2349146301,26036568,2375182869
Leather & Allied Products,September,2013,Q3,September 2013,-2151671358,23407344,2175078702
Leather & Allied Products,October,2013,Q4,October 2013,-2122277591,28815683,2151093274
Leather & Allied Products,November,2013,Q4,November 2013,-1685334352,29334601,1714668953
Leather & Allied Products,December,2013,Q4,December 2013,-1694761561,33215101,1727976662
Leather & Allied Products,January,2014,Q1,January 2014,-2319189805,30605041,2349794846
Leather & Allied Products,February,2014,Q1,February 2014,-1989510670,37899574,2027410244
Leather & Allied Products,March,2014,Q1,March 2014,-1404706529,38314310,1443020839
Leather & Allied Products,April,2014,Q2,April 2014,-1721255473,37265082,1758520555
Leather & Allied Products,May,2014,Q2,May 2014,-1771057108,34747153,1805804261
Leather & Allied Products,June,2014,Q2,June 2014,-2104978516,38088993,2143067509
Leather & Allied Products,July,2014,Q3,July 2014,-2344343240,38493778,2382837018
Leather & Allied Products,August,2014,Q3,August 2014,-2203734832,44742905,2248477737
Leather & Allied Products,September,2014,Q3,September 2014,-2233535270,41083259,2274618529
Leather & Allied Products,October,2014,Q4,October 2014,-2188725100,42763723,2231488823
Leather & Allied Products,November,2014,Q4,November 2014,-1578967555,49282148,1628249703
Leather & Allied Products,December,2014,Q4,December 2014,-1671975808,48652952,1720628760
Leather & Allied Products,January,2015,Q1,January 2015,-2020164283,31649979,2051814262
Leather & Allied Products,February,2015,Q1,February 2015,-1819027285,25318046,1844345331
Leather & Allied Products,March,2015,Q1,March 2015,-2098905407,49653222,2148558629
Leather & Allied Products,April,2015,Q2,April 2015,-1444477445,36505839,1480983284
Leather & Allied Products,May,2015,Q2,May 2015,-1803794757,41114295,1844909052
Leather & Allied Products,June,2015,Q2,June 2015,-2298347484,29230724,2327578208
Leather & Allied Products,July,2015,Q3,July 2015,-2387711023,38264063,2425975086
Leather & Allied Products,August,2015,Q3,August 2015,-2527821311,31371687,2559192998
Leather & Allied Products,September,2015,Q3,September 2015,-2315688538,30866817,2346555355
Leather & Allied Products,October,2015,Q4,October 2015,-1899801874,39058331,1938860205
Leather & Allied Products,November,2015,Q4,November 2015,-1514017336,42203690,1556221026
Leather & Allied Products,December,2015,Q4,December 2015,-1594580043,47184736,1641764779
Leather & Allied Products,January,2016,Q1,January 2016,-2036003185,37819554,2073822739
Leather & Allied Products,February,2016,Q1,February 2016,-2071399259,27658981,2099058240
Leather & Allied Products,March,2016,Q1,March 2016,-1010224235,35461831,1045686066
Leather & Allied Products,April,2016,Q2,April 2016,-1286965115,36042860,1323007975
Leather & Allied Products,May,2016,Q2,May 2016,-1591704505,40308461,1632012966
Leather & Allied Products,June,2016,Q2,June 2016,-1860662256,34294075,1894956331
Leather & Allied Products,July,2016,Q3,July 2016,-2030354573,40155454,2070510027
Leather & Allied Products,August,2016,Q3,August 2016,-2127907744,25828223,2153735967
Leather & Allied Products,September,2016,Q3,September 2016,-1780854292,32351806,1813206098
Leather & Allied Products,October,2016,Q4,October 2016,-1677920964,37886678,1715807642
Leather & Allied Products,November,2016,Q4,November 2016,-1446729779,34481448,1481211227
Leather & Allied Products,December,2016,Q4,December 2016,-1512288079,40165063,1552453142
Leather & Allied Products,January,2017,Q1,January 2017,-2027657095,29741770,2057398865
Leather & Allied Products,February,2017,Q1,February 2017,-1612271464,31915760,1644187224
Leather & Allied Products,March,2017,Q1,March 2017,-1134670088,39261259,1173931347
Leather & Allied Products,April,2017,Q2,April 2017,-1312926408,37124410,1350050818
Leather & Allied Products,May,2017,Q2,May 2017,-1615372105,34706563,1650078668
Leather & Allied Products,June,2017,Q2,June 2017,-1811498801,30160514,1841659315
Leather & Allied Products,July,2017,Q3,July 2017,-2001047033,27210626,2028257659
Leather & Allied Products,August,2017,Q3,August 2017,-1976345492,37583838,2013929330
Leather & Allied Products,September,2017,Q3,September 2017,-1729857369,38660825,1768518194
Leather & Allied Products,October,2017,Q4,October 2017,-1702257882,43440363,1745698245
Leather & Allied Products,November,2017,Q4,November 2017,-1423423587,31870600,1455294187
Leather & Allied Products,December,2017,Q4,December 2017,-1431349994,38170508,1469520502
Leather & Allied Products,January,2018,Q1,January 2018,-1985176450,37313799,2022490249
Leather & Allied Products,February,2018,Q1,February 2018,-1707817845,28704163,1736522008
Leather & Allied Products,March,2018,Q1,March 2018,-1091650871,43365548,1135016419
Leather & Allied Products,April,2018,Q2,April 2018,-1209442036,39726018,1249168054
Leather & Allied Products,May,2018,Q2,May 2018,-1501472895,41551622,1543024517
Leather & Allied Products,June,2018,Q2,June 2018,-1673973824,39754703,1713728527
Leather & Allied Products,July,2018,Q3,July 2018,-1955275963,40403931,1995679894
Leather & Allied Products,August,2018,Q3,August 2018,-1826746399,41529253,1868275652
Leather & Allied Products,September,2018,Q3,September 2018,-1775108125,38077441,1813185566
Leather & Allied Products,October,2018,Q4,October 2018,-1854772078,37147991,1891920069
Leather & Allied Products,November,2018,Q4,November 2018,-1421338428,31259499,1452597927
Leather & Allied Products,December,2018,Q4,December 2018,-1528578822,35423956,1564002778
Leather & Allied Products,January,2019,Q1,January 2019,-1880566479,30738055,1911304534
Leather & Allied Products,February,2019,Q1,February 2019,-1527353890,28971815,1556325705
Leather & Allied Products,March,2019,Q1,March 2019,-973759348,43576261,1017335609
Leather & Allied Products,April,2019,Q2,April 2019,-1117972333,35895788,1153868121
Leather & Allied Products,May,2019,Q2,May 2019,-1392847787,40819520,1433667307
Leather & Allied Products,June,2019,Q2,June 2019,-1509676841,40902352,1550579193
Leather & Allied Products,July,2019,Q3,July 2019,-1843243653,44428208,1887671861
Leather & Allied Products,August,2019,Q3,August 2019,-1642099806,43532379,1685632185
Leather & Allied Products,September,2019,Q3,September 2019,-1525639986,45210877,1570850863
Leather & Allied Products,October,2019,Q4,October 2019,-1306792768,46675204,1353467972
Leather & Allied Products,November,2019,Q4,November 2019,-1083496980,31725697,1115222677
Leather & Allied Products,December,2019,Q4,December 2019,-1120675428,34463427,1155138855
Wood Products,January,2002,Q1,January 2002,-71874525,9101676,80976201
Wood Products,February,2002,Q1,February 2002,-69455583,9980310,79435893
Wood Products,March,2002,Q1,March 2002,-47988702,12936584,60925286
Wood Products,April,2002,Q2,April 2002,-64334736,14658980,78993716
Wood Products,May,2002,Q2,May 2002,-76836360,16021766,92858126
Wood Products,June,2002,Q2,June 2002,-79912449,15264407,95176856
Wood Products,July,2002,Q3,July 2002,-85351645,15992136,101343781
Wood Products,August,2002,Q3,August 2002,-100101825,14915179,115017004
Wood Products,September,2002,Q3,September 2002,-90231064,15759533,105990597
Wood Products,October,2002,Q4,October 2002,-75224023,12527606,87751629
Wood Products,November,2002,Q4,November 2002,-79882342,14107065,93989407
Wood Products,December,2002,Q4,December 2002,-91643395,12077485,103720880
Wood Products,January,2003,Q1,January 2003,-99434571,12437808,111872379
Wood Products,February,2003,Q1,February 2003,-81380855,15238560,96619415
Wood Products,March,2003,Q1,March 2003,-67719075,15886873,83605948
Wood Products,April,2003,Q2,April 2003,-84718308,15892948,100611256
Wood Products,May,2003,Q2,May 2003,-89728657,14476550,104205207
Wood Products,June,2003,Q2,June 2003,-87788758,15388771,103177529
Wood Products,July,2003,Q3,July 2003,-96897877,14552703,111450580
Wood Products,August,2003,Q3,August 2003,-105808927,15965805,121774732
Wood Products,September,2003,Q3,September 2003,-93758927,17075877,110834804
Wood Products,October,2003,Q4,October 2003,-102606397,19359117,121965514
Wood Products,November,2003,Q4,November 2003,-82759904,21597492,104357396
Wood Products,December,2003,Q4,December 2003,-95429100,18686560,114115660
Wood Products,January,2004,Q1,January 2004,-104720686,17737208,122457894
Wood Products,February,2004,Q1,February 2004,-81009264,17369556,98378820
Wood Products,March,2004,Q1,March 2004,-82840699,24494873,107335572
Wood Products,April,2004,Q2,April 2004,-104213986,23057220,127271206
Wood Products,May,2004,Q2,May 2004,-118247841,27064198,145312039
Wood Products,June,2004,Q2,June 2004,-140939776,24902643,165842419
Wood Products,July,2004,Q3,July 2004,-148170397,21964767,170135164
Wood Products,August,2004,Q3,August 2004,-150367281,21636662,172003943
Wood Products,September,2004,Q3,September 2004,-155774206,19730179,175504385
Wood Products,October,2004,Q4,October 2004,-160013467,18888548,178902015
Wood Products,November,2004,Q4,November 2004,-154966615,28448228,183414843
Wood Products,December,2004,Q4,December 2004,-154432223,21822268,176254491
Wood Products,January,2005,Q1,January 2005,-162580484,19128381,181708865
Wood Products,February,2005,Q1,February 2005,-144800970,22701559,167502529
Wood Products,March,2005,Q1,March 2005,-110451257,24507021,134958278
Wood Products,April,2005,Q2,April 2005,-134081924,29308447,163390371
Wood Products,May,2005,Q2,May 2005,-156707109,34208631,190915740
Wood Products,June,2005,Q2,June 2005,-184806238,30844461,215650699
Wood Products,July,2005,Q3,July 2005,-175556868,25402448,200959316
Wood Products,August,2005,Q3,August 2005,-192976137,28491759,221467896
Wood Products,September,2005,Q3,September 2005,-194609592,22412682,217022274
Wood Products,October,2005,Q4,October 2005,-193157632,27203288,220360920
Wood Products,November,2005,Q4,November 2005,-177614279,26456584,204070863
Wood Products,December,2005,Q4,December 2005,-171993907,25222484,197216391
Wood Products,January,2006,Q1,January 2006,-185242415,26354824,211597239
Wood Products,February,2006,Q1,February 2006,-157480604,27705793,185186397
Wood Products,March,2006,Q1,March 2006,-136376752,31050889,167427641
Wood Products,April,2006,Q2,April 2006,-196652250,30728807,227381057
Wood Products,May,2006,Q2,May 2006,-216599093,35850014,252449107
Wood Products,June,2006,Q2,June 2006,-253075564,34233767,287309331
Wood Products,July,2006,Q3,July 2006,-261701108,36171387,297872495
Wood Products,August,2006,Q3,August 2006,-275920426,34770696,310691122
Wood Products,September,2006,Q3,September 2006,-257880752,29794140,287674892
Wood Products,October,2006,Q4,October 2006,-258075447,30835126,288910573
Wood Products,November,2006,Q4,November 2006,-223299588,29938585,253238173
Wood Products,December,2006,Q4,December 2006,-186947768,37568602,224516370
Wood Products,January,2007,Q1,January 2007,-223385975,22716905,246102880
Wood Products,February,2007,Q1,February 2007,-178980993,34054347,213035340
Wood Products,March,2007,Q1,March 2007,-163038256,29418811,192457067
Wood Products,April,2007,Q2,April 2007,-180407975,32077937,212485912
Wood Products,May,2007,Q2,May 2007,-230458002,32455991,262913993
Wood Products,June,2007,Q2,June 2007,-249622490,32988703,282611193
Wood Products,July,2007,Q3,July 2007,-267719794,29243369,296963163
Wood Products,August,2007,Q3,August 2007,-255059356,32024816,287084172
Wood Products,September,2007,Q3,September 2007,-267921349,26777228,294698577
Wood Products,October,2007,Q4,October 2007,-243160180,27857450,271017630
Wood Products,November,2007,Q4,November 2007,-245928082,27326372,273254454
Wood Products,December,2007,Q4,December 2007,-218446181,26723166,245169347
Wood Products,January,2008,Q1,January 2008,-257013813,18099644,275113457
Wood Products,February,2008,Q1,February 2008,-225461229,28339921,253801150
Wood Products,March,2008,Q1,March 2008,-133952142,25422247,159374389
Wood Products,April,2008,Q2,April 2008,-191781380,26777244,218558624
Wood Products,May,2008,Q2,May 2008,-218470406,31247364,249717770
Wood Products,June,2008,Q2,June 2008,-206056416,31325238,237381654
Wood Products,July,2008,Q3,July 2008,-229097806,28453309,257551115
Wood Products,August,2008,Q3,August 2008,-247425449,29261311,276686760
Wood Products,September,2008,Q3,September 2008,-218041164,27912015,245953179
Wood Products,October,2008,Q4,October 2008,-227384571,23066710,250451281
Wood Products,November,2008,Q4,November 2008,-204564791,20227208,224791999
Wood Products,December,2008,Q4,December 2008,-177857745,13542078,191399823
Wood Products,January,2009,Q1,January 2009,-190542234,16278562,206820796
Wood Products,February,2009,Q1,February 2009,-141418445,15518183,156936628
Wood Products,March,2009,Q1,March 2009,-121957035,20821007,142778042
Wood Products,April,2009,Q2,April 2009,-161372958,19971303,181344261
Wood Products,May,2009,Q2,May 2009,-173700457,22779104,196479561
Wood Products,June,2009,Q2,June 2009,-162050662,28250183,190300845
Wood Products,July,2009,Q3,July 2009,-163226161,28821234,192047395
Wood Products,August,2009,Q3,August 2009,-168324526,28478835,196803361
Wood Products,September,2009,Q3,September 2009,-166998468,31411097,198409565
Wood Products,October,2009,Q4,October 2009,-163917366,35634305,199551671
Wood Products,November,2009,Q4,November 2009,-156846590,33863547,190710137
Wood Products,December,2009,Q4,December 2009,-163469599,33407594,196877193
Wood Products,January,2010,Q1,January 2010,-185277134,22727838,208004972
Wood Products,February,2010,Q1,February 2010,-153132847,40392296,193525143
Wood Products,March,2010,Q1,March 2010,-143195730,40149484,183345214
Wood Products,April,2010,Q2,April 2010,-135949247,43657288,179606535
Wood Products,May,2010,Q2,May 2010,-181253913,52572214,233826127
Wood Products,June,2010,Q2,June 2010,-203822218,49007863,252830081
Wood Products,July,2010,Q3,July 2010,-222562706,47031964,269594670
Wood Products,August,2010,Q3,August 2010,-230842276,44999164,275841440
Wood Products,September,2010,Q3,September 2010,-184578456,44747463,229325919
Wood Products,October,2010,Q4,October 2010,-186666443,46246291,232912734
Wood Products,November,2010,Q4,November 2010,-168939294,51324051,220263345
Wood Products,December,2010,Q4,December 2010,-164597522,42674434,207271956
Wood Products,January,2011,Q1,January 2011,-186524298,61177509,247701807
Wood Products,February,2011,Q1,February 2011,-177175387,72741442,249916829
Wood Products,March,2011,Q1,March 2011,-93575844,76820899,170396743
Wood Products,April,2011,Q2,April 2011,-116964582,74350420,191315002
Wood Products,May,2011,Q2,May 2011,-162552538,89261243,251813781
Wood Products,June,2011,Q2,June 2011,-173764974,75476047,249241021
Wood Products,July,2011,Q3,July 2011,-182102066,69638906,251740972
Wood Products,August,2011,Q3,August 2011,-199794610,66967071,266761681
Wood Products,September,2011,Q3,September 2011,-176716181,63565520,240281701
Wood Products,October,2011,Q4,October 2011,-153469963,73894570,227364533
Wood Products,November,2011,Q4,November 2011,-156390951,74476786,230867737
Wood Products,December,2011,Q4,December 2011,-178406809,50447445,228854254
Wood Products,January,2012,Q1,January 2012,-197350003,74262208,271612211
Wood Products,February,2012,Q1,February 2012,-156404340,53476808,209881148
Wood Products,March,2012,Q1,March 2012,-124726312,63998152,188724464
Wood Products,April,2012,Q2,April 2012,-173329058,66059063,239388121
Wood Products,May,2012,Q2,May 2012,-217197413,71624927,288822340
Wood Products,June,2012,Q2,June 2012,-223484124,73156753,296640877
Wood Products,July,2012,Q3,July 2012,-237378554,69612162,306990716
Wood Products,August,2012,Q3,August 2012,-205957547,70865743,276823290
Wood Products,September,2012,Q3,September 2012,-209576569,71678320,281254889
Wood Products,October,2012,Q4,October 2012,-206886419,74191766,281078185
Wood Products,November,2012,Q4,November 2012,-180368441,80952705,261321146
Wood Products,December,2012,Q4,December 2012,-210531157,69995155,280526312
Wood Products,January,2013,Q1,January 2013,-233718100,74786844,308504944
Wood Products,February,2013,Q1,February 2013,-209318171,87926503,297244674
Wood Products,March,2013,Q1,March 2013,-84503866,76754330,161258196
Wood Products,April,2013,Q2,April 2013,-156184060,93921169,250105229
Wood Products,May,2013,Q2,May 2013,-165462273,100466269,265928542
Wood Products,June,2013,Q2,June 2013,-191018523,85129662,276148185
Wood Products,July,2013,Q3,July 2013,-192031937,108372139,300404076
Wood Products,August,2013,Q3,August 2013,-214371659,92945590,307317249
Wood Products,September,2013,Q3,September 2013,-174485854,116589297,291075151
Wood Products,October,2013,Q4,October 2013,-173549135,130238060,303787195
Wood Products,November,2013,Q4,November 2013,-145055987,143671933,288727920
Wood Products,December,2013,Q4,December 2013,-184273345,87258981,271532326
Wood Products,January,2014,Q1,January 2014,-201972092,130685270,332657362
Wood Products,February,2014,Q1,February 2014,-144128732,121611168,265739900
Wood Products,March,2014,Q1,March 2014,-68102097,132802961,200905058
Wood Products,April,2014,Q2,April 2014,-145753432,134633706,280387138
Wood Products,May,2014,Q2,May 2014,-189855988,134480597,324336585
Wood Products,June,2014,Q2,June 2014,-230874329,111171689,342046018
Wood Products,July,2014,Q3,July 2014,-246402949,102018290,348421239
Wood Products,August,2014,Q3,August 2014,-230088503,91958632,322047135
Wood Products,September,2014,Q3,September 2014,-228234510,112348011,340582521
Wood Products,October,2014,Q4,October 2014,-200381487,127596411,327977898
Wood Products,November,2014,Q4,November 2014,-177463625,127206712,304670337
Wood Products,December,2014,Q4,December 2014,-219914626,102200181,322114807
Wood Products,January,2015,Q1,January 2015,-246643175,93881624,340524799
Wood Products,February,2015,Q1,February 2015,-177845343,110123416,287968759
Wood Products,March,2015,Q1,March 2015,-266014759,117176103,383190862
Wood Products,April,2015,Q2,April 2015,-163625231,105204443,268829674
Wood Products,May,2015,Q2,May 2015,-256919464,104108181,361027645
Wood Products,June,2015,Q2,June 2015,-283358288,92204584,375562872
Wood Products,July,2015,Q3,July 2015,-270758268,77959828,348718096
Wood Products,August,2015,Q3,August 2015,-259396551,97199803,356596354
Wood Products,September,2015,Q3,September 2015,-208705072,115092034,323797106
Wood Products,October,2015,Q4,October 2015,-205047459,115246911,320294370
Wood Products,November,2015,Q4,November 2015,-192786795,120629491,313416286
Wood Products,December,2015,Q4,December 2015,-266010501,59395006,325405507
Wood Products,January,2016,Q1,January 2016,-214143120,127524439,341667559
Wood Products,February,2016,Q1,February 2016,-225311241,122475557,347786798
Wood Products,March,2016,Q1,March 2016,-113462855,108615040,222077895
Wood Products,April,2016,Q2,April 2016,-134406053,122192729,256598782
Wood Products,May,2016,Q2,May 2016,-222915048,126545396,349460444
Wood Products,June,2016,Q2,June 2016,-228762475,120458362,349220837
Wood Products,July,2016,Q3,July 2016,-234536068,130344248,364880316
Wood Products,August,2016,Q3,August 2016,-234683832,131157671,365841503
Wood Products,September,2016,Q3,September 2016,-188751053,140342580,329093633
Wood Products,October,2016,Q4,October 2016,-191296811,152734022,344030833
Wood Products,November,2016,Q4,November 2016,-174712882,152690249,327403131
Wood Products,December,2016,Q4,December 2016,-275899644,86241727,362141371
Wood Products,January,2017,Q1,January 2017,-256566903,157689684,414256587
Wood Products,February,2017,Q1,February 2017,-217461370,133745181,351206551
Wood Products,March,2017,Q1,March 2017,-127911338,151811315,279722653
Wood Products,April,2017,Q2,April 2017,-147400663,154376928,301777591
Wood Products,May,2017,Q2,May 2017,-200774089,163050147,363824236
Wood Products,June,2017,Q2,June 2017,-187676073,156097613,343773686
Wood Products,July,2017,Q3,July 2017,-163791938,156209937,320001875
Wood Products,August,2017,Q3,August 2017,-165558868,158280397,323839265
Wood Products,September,2017,Q3,September 2017,-139618053,174467300,314085353
Wood Products,October,2017,Q4,October 2017,-150365159,175732998,326098157
Wood Products,November,2017,Q4,November 2017,-143788164,169992063,313780227
Wood Products,December,2017,Q4,December 2017,-179748302,147036047,326784349
Wood Products,January,2018,Q1,January 2018,-238572793,131035087,369607880
Wood Products,February,2018,Q1,February 2018,-183730287,174060985,357791272
Wood Products,March,2018,Q1,March 2018,-146574574,168238393,314812967
Wood Products,April,2018,Q2,April 2018,-45523966,184596863,230120829
Wood Products,May,2018,Q2,May 2018,-171039535,169251478,340291013
Wood Products,June,2018,Q2,June 2018,-224846979,161036741,385883720
Wood Products,July,2018,Q3,July 2018,-246123240,128369425,374492665
Wood Products,August,2018,Q3,August 2018,-256125646,106364606,362490252
Wood Products,September,2018,Q3,September 2018,-226289520,89601652,315891172
Wood Products,October,2018,Q4,October 2018,-184037735,141831650,325869385
Wood Products,November,2018,Q4,November 2018,-216160349,96029881,312190230
Wood Products,December,2018,Q4,December 2018,-379559665,36438931,415998596
Wood Products,January,2019,Q1,January 2019,-203145900,90436497,293582397
Wood Products,February,2019,Q1,February 2019,-187822508,64197205,252019713
Wood Products,March,2019,Q1,March 2019,-89834290,94574558,184408848
Wood Products,April,2019,Q2,April 2019,-83921829,119428940,203350769
Wood Products,May,2019,Q2,May 2019,-174024208,86722659,260746867
Wood Products,June,2019,Q2,June 2019,-176290937,71318801,247609738
Wood Products,July,2019,Q3,July 2019,-197093926,70849838,267943764
Wood Products,August,2019,Q3,August 2019,-185282740,63244872,248527612
Wood Products,September,2019,Q3,September 2019,-161947467,61000583,222948050
Wood Products,October,2019,Q4,October 2019,-146207082,66094135,212301217
Wood Products,November,2019,Q4,November 2019,-156152127,51772909,207925036
Wood Products,December,2019,Q4,December 2019,-189234733,30818138,220052871
Paper,January,2002,Q1,January 2002,-13492567,43472356,56964923
Paper,February,2002,Q1,February 2002,5294437,55830662,50536225
Paper,March,2002,Q1,March 2002,12743765,58333796,45590031
Paper,April,2002,Q2,April 2002,-4687474,56508851,61196325
Paper,May,2002,Q2,May 2002,-14551801,53982425,68534226
Paper,June,2002,Q2,June 2002,-14899751,58987345,73887096
Paper,July,2002,Q3,July 2002,-21919780,54928660,76848440
Paper,August,2002,Q3,August 2002,-35610638,56280823,91891461
Paper,September,2002,Q3,September 2002,-43283612,47013387,90296999
Paper,October,2002,Q4,October 2002,-43358081,43272658,86630739
Paper,November,2002,Q4,November 2002,-48530656,44794411,93325067
Paper,December,2002,Q4,December 2002,-17901128,67786481,85687609
Paper,January,2003,Q1,January 2003,-32981872,52927007,85908879
Paper,February,2003,Q1,February 2003,-12705906,55946964,68652870
Paper,March,2003,Q1,March 2003,1263285,67706329,66443044
Paper,April,2003,Q2,April 2003,-18577050,63421376,81998426
Paper,May,2003,Q2,May 2003,-27873379,57122692,84996071
Paper,June,2003,Q2,June 2003,-45864871,47458558,93323429
Paper,July,2003,Q3,July 2003,-48261049,48815080,97076129
Paper,August,2003,Q3,August 2003,-56423214,50121257,106544471
Paper,September,2003,Q3,September 2003,-75210249,44657265,119867514
Paper,October,2003,Q4,October 2003,-80492783,53519432,134012215
Paper,November,2003,Q4,November 2003,-53799301,60392025,114191326
Paper,December,2003,Q4,December 2003,-47030877,54075521,101106398
Paper,January,2004,Q1,January 2004,-24269339,72198835,96468174
Paper,February,2004,Q1,February 2004,15913100,79512374,63599274
Paper,March,2004,Q1,March 2004,1434931,81602622,80167691
Paper,April,2004,Q2,April 2004,-29116866,72576583,101693449
Paper,May,2004,Q2,May 2004,-33062932,74324116,107387048
Paper,June,2004,Q2,June 2004,-55320577,62512404,117832981
Paper,July,2004,Q3,July 2004,-60415871,62877131,123293002
Paper,August,2004,Q3,August 2004,-65762900,67884202,133647102
Paper,September,2004,Q3,September 2004,-85282988,53501117,138784105
Paper,October,2004,Q4,October 2004,-84654098,52116862,136770960
Paper,November,2004,Q4,November 2004,-71221236,69222822,140444058
Paper,December,2004,Q4,December 2004,-54460532,66196768,120657300
Paper,January,2005,Q1,January 2005,-48255366,71525100,119780466
Paper,February,2005,Q1,February 2005,-33481949,77607603,111089552
Paper,March,2005,Q1,March 2005,-26960494,70577649,97538143
Paper,April,2005,Q2,April 2005,-40561588,79470604,120032192
Paper,May,2005,Q2,May 2005,-58405663,73031394,131437057
Paper,June,2005,Q2,June 2005,-86935046,61195154,148130200
Paper,July,2005,Q3,July 2005,-93687010,62145239,155832249
Paper,August,2005,Q3,August 2005,-107289990,77214732,184504722
Paper,September,2005,Q3,September 2005,-102971142,74080639,177051781
Paper,October,2005,Q4,October 2005,-98795608,78356043,177151651
Paper,November,2005,Q4,November 2005,-93806074,70597718,164403792
Paper,December,2005,Q4,December 2005,-71918687,74776660,146695347
Paper,January,2006,Q1,January 2006,-94751055,67506117,162257172
Paper,February,2006,Q1,February 2006,-55646672,67893101,123539773
Paper,March,2006,Q1,March 2006,-59318662,84092886,143411548
Paper,April,2006,Q2,April 2006,-92261430,76221949,168483379
Paper,May,2006,Q2,May 2006,-101897756,74586757,176484513
Paper,June,2006,Q2,June 2006,-110392840,81276293,191669133
Paper,July,2006,Q3,July 2006,-101794861,85275035,187069896
Paper,August,2006,Q3,August 2006,-148171351,86268992,234440343
Paper,September,2006,Q3,September 2006,-144910211,81844146,226754357
Paper,October,2006,Q4,October 2006,-150846440,90962370,241808810
Paper,November,2006,Q4,November 2006,-143360365,85431940,228792305
Paper,December,2006,Q4,December 2006,-93943391,98238372,192181763
Paper,January,2007,Q1,January 2007,-99314174,79943353,179257527
Paper,February,2007,Q1,February 2007,-78852985,96055175,174908160
Paper,March,2007,Q1,March 2007,-38904401,109375912,148280313
Paper,April,2007,Q2,April 2007,-69360797,103388217,172749014
Paper,May,2007,Q2,May 2007,-80069230,108528726,188597956
Paper,June,2007,Q2,June 2007,-100507645,102751308,203258953
Paper,July,2007,Q3,July 2007,-129709419,101049649,230759068
Paper,August,2007,Q3,August 2007,-156809376,104521759,261331135
Paper,September,2007,Q3,September 2007,-156424919,111620795,268045714
Paper,October,2007,Q4,October 2007,-160913977,124678731,285592708
Paper,November,2007,Q4,November 2007,-142803498,112280584,255084082
Paper,December,2007,Q4,December 2007,-94716679,129152325,223869004
Paper,January,2008,Q1,January 2008,-82441214,108057201,190498415
Paper,February,2008,Q1,February 2008,-57846598,128558416,186405014
Paper,March,2008,Q1,March 2008,-36006373,121647872,157654245
Paper,April,2008,Q2,April 2008,-68012909,128357898,196370807
Paper,May,2008,Q2,May 2008,-100397336,125387292,225784628
Paper,June,2008,Q2,June 2008,-92399009,123742178,216141187
Paper,July,2008,Q3,July 2008,-126560729,131861751,258422480
Paper,August,2008,Q3,August 2008,-153698610,136189953,289888563
Paper,September,2008,Q3,September 2008,-182097727,114457669,296555396
Paper,October,2008,Q4,October 2008,-200225448,95442942,295668390
Paper,November,2008,Q4,November 2008,-199306214,76933409,276239623
Paper,December,2008,Q4,December 2008,-144282478,77379756,221662234
Paper,January,2009,Q1,January 2009,-133710790,78523018,212233808
Paper,February,2009,Q1,February 2009,-49228888,93577181,142806069
Paper,March,2009,Q1,March 2009,-48078395,108692834,156771229
Paper,April,2009,Q2,April 2009,-79181482,104611301,183792783
Paper,May,2009,Q2,May 2009,-62020864,125645040,187665904
Paper,June,2009,Q2,June 2009,-38751653,147507528,186259181
Paper,July,2009,Q3,July 2009,-65179512,149851796,215031308
Paper,August,2009,Q3,August 2009,-66505628,170754460,237260088
Paper,September,2009,Q3,September 2009,-88738969,160970677,249709646
Paper,October,2009,Q4,October 2009,-79860010,165795542,245655552
Paper,November,2009,Q4,November 2009,-56861629,169285896,226147525
Paper,December,2009,Q4,December 2009,-57494140,155692955,213187095
Paper,January,2010,Q1,January 2010,-57502665,150573256,208075921
Paper,February,2010,Q1,February 2010,-24726472,160859389,185585861
Paper,March,2010,Q1,March 2010,-17449465,147992865,165442330
Paper,April,2010,Q2,April 2010,19147558,199449503,180301945
Paper,May,2010,Q2,May 2010,-31154167,182632771,213786938
Paper,June,2010,Q2,June 2010,-61135850,166857247,227993097
Paper,July,2010,Q3,July 2010,-66237571,176010352,242247923
Paper,August,2010,Q3,August 2010,-105996667,169710867,275707534
Paper,September,2010,Q3,September 2010,-115070451,169914978,284985429
Paper,October,2010,Q4,October 2010,-66914984,203980770,270895754
Paper,November,2010,Q4,November 2010,-75292861,185394584,260687445
Paper,December,2010,Q4,December 2010,-22675305,197503396,220178701
Paper,January,2011,Q1,January 2011,-14324872,208132228,222457100
Paper,February,2011,Q1,February 2011,15203573,208880357,193676784
Paper,March,2011,Q1,March 2011,90151583,241927752,151776169
Paper,April,2011,Q2,April 2011,27250646,236832965,209582319
Paper,May,2011,Q2,May 2011,22356548,250244615,227888067
Paper,June,2011,Q2,June 2011,-37449898,207245536,244695434
Paper,July,2011,Q3,July 2011,-57798439,207133574,264932013
Paper,August,2011,Q3,August 2011,-61684601,232074443,293759044
Paper,September,2011,Q3,September 2011,-42613651,269375971,311989622
Paper,October,2011,Q4,October 2011,-1736795,274397702,276134497
Paper,November,2011,Q4,November 2011,-91773580,211244105,303017685
Paper,December,2011,Q4,December 2011,-32690046,208875619,241565665
Paper,January,2012,Q1,January 2012,25673723,223861862,198188139
Paper,February,2012,Q1,February 2012,74723136,229754443,155031307
Paper,March,2012,Q1,March 2012,73934509,229655022,155720513
Paper,April,2012,Q2,April 2012,30106381,212725202,182618821
Paper,May,2012,Q2,May 2012,37970189,232594809,194624620
Paper,June,2012,Q2,June 2012,20387853,221821222,201433369
Paper,July,2012,Q3,July 2012,-6716738,215427628,222144366
Paper,August,2012,Q3,August 2012,-52771309,194477899,247249208
Paper,September,2012,Q3,September 2012,-74505170,210003633,284508803
Paper,October,2012,Q4,October 2012,-63975328,198248207,262223535
Paper,November,2012,Q4,November 2012,-43154070,189417015,232571085
Paper,December,2012,Q4,December 2012,6387590,202565830,196178240
Paper,January,2013,Q1,January 2013,7982795,205990987,198008192
Paper,February,2013,Q1,February 2013,10762526,198135034,187372508
Paper,March,2013,Q1,March 2013,83968778,210579880,126611102
Paper,April,2013,Q2,April 2013,29213843,204127989,174914146
Paper,May,2013,Q2,May 2013,8920135,208721299,199801164
Paper,June,2013,Q2,June 2013,3024650,199605929,196581279
Paper,July,2013,Q3,July 2013,-9675909,216848668,226524577
Paper,August,2013,Q3,August 2013,-55453438,212878461,268331899
Paper,September,2013,Q3,September 2013,-55529765,230224445,285754210
Paper,October,2013,Q4,October 2013,-43496144,241820899,285317043
Paper,November,2013,Q4,November 2013,-22482349,222130251,244612600
Paper,December,2013,Q4,December 2013,4420019,207656778,203236759
Paper,January,2014,Q1,January 2014,9238015,230242557,221004542
Paper,February,2014,Q1,February 2014,8723956,191720351,182996395
Paper,March,2014,Q1,March 2014,42832477,202852377,160019900
Paper,April,2014,Q2,April 2014,15192639,206482291,191289652
Paper,May,2014,Q2,May 2014,-25284345,189075516,214359861
Paper,June,2014,Q2,June 2014,-34782441,194694485,229476926
Paper,July,2014,Q3,July 2014,-57271005,187139445,244410450
Paper,August,2014,Q3,August 2014,-66071402,198116401,264187803
Paper,September,2014,Q3,September 2014,-107543863,210730639,318274502
Paper,October,2014,Q4,October 2014,-107742081,208171573,315913654
Paper,November,2014,Q4,November 2014,-38451955,215701280,254153235
Paper,December,2014,Q4,December 2014,-14099018,209075842,223174860
Paper,January,2015,Q1,January 2015,-10936239,202725693,213661932
Paper,February,2015,Q1,February 2015,15682342,199264162,183581820
Paper,March,2015,Q1,March 2015,-27745542,211047899,238793441
Paper,April,2015,Q2,April 2015,6615409,207053438,200438029
Paper,May,2015,Q2,May 2015,-33707024,201512241,235219265
Paper,June,2015,Q2,June 2015,-25124795,219278422,244403217
Paper,July,2015,Q3,July 2015,-23496417,223594645,247091062
Paper,August,2015,Q3,August 2015,-111505221,193571345,305076566
Paper,September,2015,Q3,September 2015,-130773465,204538724,335312189
Paper,October,2015,Q4,October 2015,-91352118,213288423,304640541
Paper,November,2015,Q4,November 2015,-71306968,190921944,262228912
Paper,December,2015,Q4,December 2015,-39186525,177772669,216959194
Paper,January,2016,Q1,January 2016,-49242170,185265570,234507740
Paper,February,2016,Q1,February 2016,-56900405,188036925,244937330
Paper,March,2016,Q1,March 2016,22065004,177046521,154981517
Paper,April,2016,Q2,April 2016,-24228995,175067565,199296560
Paper,May,2016,Q2,May 2016,-44750000,191360216,236110216
Paper,June,2016,Q2,June 2016,-50103480,190969099,241072579
Paper,July,2016,Q3,July 2016,-37611172,214826279,252437451
Paper,August,2016,Q3,August 2016,-108855838,213347266,322203104
Paper,September,2016,Q3,September 2016,-93765155,218380523,312145678
Paper,October,2016,Q4,October 2016,-110835787,219293468,330129255
Paper,November,2016,Q4,November 2016,-87620376,205235138,292855514
Paper,December,2016,Q4,December 2016,-59055342,194473147,253528489
Paper,January,2017,Q1,January 2017,-28957655,234932545,263890200
Paper,February,2017,Q1,February 2017,6790843,218411086,211620243
Paper,March,2017,Q1,March 2017,20838234,207918974,187080740
Paper,April,2017,Q2,April 2017,-45384565,186603758,231988323
Paper,May,2017,Q2,May 2017,-93065068,171367619,264432687
Paper,June,2017,Q2,June 2017,-78905648,179343637,258249285
Paper,July,2017,Q3,July 2017,-71341298,204908630,276249928
Paper,August,2017,Q3,August 2017,-124443224,198760715,323203939
Paper,September,2017,Q3,September 2017,-105086239,237788520,342874759
Paper,October,2017,Q4,October 2017,-68410106,279954704,348364810
Paper,November,2017,Q4,November 2017,-31724424,268186046,299910470
Paper,December,2017,Q4,December 2017,10632014,276714566,266082552
Paper,January,2018,Q1,January 2018,-70018519,223973605,293992124
Paper,February,2018,Q1,February 2018,-37747325,225887047,263634372
Paper,March,2018,Q1,March 2018,25633190,249303938,223670748
Paper,April,2018,Q2,April 2018,-13238105,204093824,217331929
Paper,May,2018,Q2,May 2018,-43493072,230747598,274240670
Paper,June,2018,Q2,June 2018,-83208416,225966159,309174575
Paper,July,2018,Q3,July 2018,-101172040,237178142,338350182
Paper,August,2018,Q3,August 2018,-133567544,221998401,355565945
Paper,September,2018,Q3,September 2018,-139257015,225034210,364291225
Paper,October,2018,Q4,October 2018,-162847137,235003806,397850943
Paper,November,2018,Q4,November 2018,-96075115,225661024,321736139
Paper,December,2018,Q4,December 2018,-147043351,182371849,329415200
Paper,January,2019,Q1,January 2019,-118625739,170473084,289098823
Paper,February,2019,Q1,February 2019,-79856095,158599443,238455538
Paper,March,2019,Q1,March 2019,41566219,221592473,180026254
Paper,April,2019,Q2,April 2019,-9715384,204422913,214138297
Paper,May,2019,Q2,May 2019,-68330706,197565233,265895939
Paper,June,2019,Q2,June 2019,-47869023,193568554,241437577
Paper,July,2019,Q3,July 2019,-80222627,191978780,272201407
Paper,August,2019,Q3,August 2019,-92597803,208846565,301444368
Paper,September,2019,Q3,September 2019,-92957370,202887738,295845108
Paper,October,2019,Q4,October 2019,-58845516,223728947,282574463
Paper,November,2019,Q4,November 2019,-36493388,195190895,231684283
Paper,December,2019,Q4,December 2019,-52366185,174377561,226743746
"Printed Matter And Related Products, Nesoi",January,2002,Q1,January 2002,-56052020,4860808,60912828
"Printed Matter And Related Products, Nesoi",February,2002,Q1,February 2002,-48642750,2856140,51498890
"Printed Matter And Related Products, Nesoi",March,2002,Q1,March 2002,-37206835,5646871,42853706
"Printed Matter And Related Products, Nesoi",April,2002,Q2,April 2002,-55466883,8807991,64274874
"Printed Matter And Related Products, Nesoi",May,2002,Q2,May 2002,-78796378,6406154,85202532
"Printed Matter And Related Products, Nesoi",June,2002,Q2,June 2002,-96110892,5670056,101780948
"Printed Matter And Related Products, Nesoi",July,2002,Q3,July 2002,-92786401,5035277,97821678
"Printed Matter And Related Products, Nesoi",August,2002,Q3,August 2002,-85985770,8494376,94480146
"Printed Matter And Related Products, Nesoi",September,2002,Q3,September 2002,-86672221,7586547,94258768
"Printed Matter And Related Products, Nesoi",October,2002,Q4,October 2002,-61186911,8281654,69468565
"Printed Matter And Related Products, Nesoi",November,2002,Q4,November 2002,-81008312,4873165,85881477
"Printed Matter And Related Products, Nesoi",December,2002,Q4,December 2002,-69813016,5845405,75658421
"Printed Matter And Related Products, Nesoi",January,2003,Q1,January 2003,-68932449,5165158,74097607
"Printed Matter And Related Products, Nesoi",February,2003,Q1,February 2003,-51101583,5287046,56388629
"Printed Matter And Related Products, Nesoi",March,2003,Q1,March 2003,-50340002,6143907,56483909
"Printed Matter And Related Products, Nesoi",April,2003,Q2,April 2003,-65551089,13131402,78682491
"Printed Matter And Related Products, Nesoi",May,2003,Q2,May 2003,-85239809,7061307,92301116
"Printed Matter And Related Products, Nesoi",June,2003,Q2,June 2003,-98902615,7537170,106439785
"Printed Matter And Related Products, Nesoi",July,2003,Q3,July 2003,-116063102,5280417,121343519
"Printed Matter And Related Products, Nesoi",August,2003,Q3,August 2003,-107880276,6671349,114551625
"Printed Matter And Related Products, Nesoi",September,2003,Q3,September 2003,-116638694,5644019,122282713
"Printed Matter And Related Products, Nesoi",October,2003,Q4,October 2003,-115046608,6905488,121952096
"Printed Matter And Related Products, Nesoi",November,2003,Q4,November 2003,-74200397,15808947,90009344
"Printed Matter And Related Products, Nesoi",December,2003,Q4,December 2003,-82121050,5471222,87592272
"Printed Matter And Related Products, Nesoi",January,2004,Q1,January 2004,-80000940,6273392,86274332
"Printed Matter And Related Products, Nesoi",February,2004,Q1,February 2004,-60683262,5338713,66021975
"Printed Matter And Related Products, Nesoi",March,2004,Q1,March 2004,-73988559,7367195,81355754
"Printed Matter And Related Products, Nesoi",April,2004,Q2,April 2004,-95502575,6670166,102172741
"Printed Matter And Related Products, Nesoi",May,2004,Q2,May 2004,-112662187,5530732,118192919
"Printed Matter And Related Products, Nesoi",June,2004,Q2,June 2004,-135763872,4856751,140620623
"Printed Matter And Related Products, Nesoi",July,2004,Q3,July 2004,-143384062,6489169,149873231
"Printed Matter And Related Products, Nesoi",August,2004,Q3,August 2004,-149158247,5241851,154400098
"Printed Matter And Related Products, Nesoi",September,2004,Q3,September 2004,-143966128,8106787,152072915
"Printed Matter And Related Products, Nesoi",October,2004,Q4,October 2004,-121451898,6073458,127525356
"Printed Matter And Related Products, Nesoi",November,2004,Q4,November 2004,-124205715,4638441,128844156
"Printed Matter And Related Products, Nesoi",December,2004,Q4,December 2004,-104847970,5289732,110137702
"Printed Matter And Related Products, Nesoi",January,2005,Q1,January 2005,-106761896,5408103,112169999
"Printed Matter And Related Products, Nesoi",February,2005,Q1,February 2005,-95113496,5600335,100713831
"Printed Matter And Related Products, Nesoi",March,2005,Q1,March 2005,-75773614,5734449,81508063
"Printed Matter And Related Products, Nesoi",April,2005,Q2,April 2005,-106727016,6625317,113352333
"Printed Matter And Related Products, Nesoi",May,2005,Q2,May 2005,-140128800,7453209,147582009
"Printed Matter And Related Products, Nesoi",June,2005,Q2,June 2005,-163087354,7044759,170132113
"Printed Matter And Related Products, Nesoi",July,2005,Q3,July 2005,-177452890,6633323,184086213
"Printed Matter And Related Products, Nesoi",August,2005,Q3,August 2005,-183026045,8336420,191362465
"Printed Matter And Related Products, Nesoi",September,2005,Q3,September 2005,-173964840,6555275,180520115
"Printed Matter And Related Products, Nesoi",October,2005,Q4,October 2005,-161590308,7904662,169494970
"Printed Matter And Related Products, Nesoi",November,2005,Q4,November 2005,-121745887,6934584,128680471
"Printed Matter And Related Products, Nesoi",December,2005,Q4,December 2005,-104218700,7083325,111302025
"Printed Matter And Related Products, Nesoi",January,2006,Q1,January 2006,-119334707,5278947,124613654
"Printed Matter And Related Products, Nesoi",February,2006,Q1,February 2006,-98943467,5822784,104766251
"Printed Matter And Related Products, Nesoi",March,2006,Q1,March 2006,-92529724,6190313,98720037
"Printed Matter And Related Products, Nesoi",April,2006,Q2,April 2006,-117993924,7522400,125516324
"Printed Matter And Related Products, Nesoi",May,2006,Q2,May 2006,-144675172,8156102,152831274
"Printed Matter And Related Products, Nesoi",June,2006,Q2,June 2006,-164853425,10121424,174974849
"Printed Matter And Related Products, Nesoi",July,2006,Q3,July 2006,-168082559,7085317,175167876
"Printed Matter And Related Products, Nesoi",August,2006,Q3,August 2006,-212522432,8605114,221127546
"Printed Matter And Related Products, Nesoi",September,2006,Q3,September 2006,-189805926,9269970,199075896
"Printed Matter And Related Products, Nesoi",October,2006,Q4,October 2006,-171434578,8491975,179926553
"Printed Matter And Related Products, Nesoi",November,2006,Q4,November 2006,-157036253,7456450,164492703
"Printed Matter And Related Products, Nesoi",December,2006,Q4,December 2006,-137456824,8834931,146291755
"Printed Matter And Related Products, Nesoi",January,2007,Q1,January 2007,-150497816,5832550,156330366
"Printed Matter And Related Products, Nesoi",February,2007,Q1,February 2007,-126787150,5752611,132539761
"Printed Matter And Related Products, Nesoi",March,2007,Q1,March 2007,-121628721,9948800,131577521
"Printed Matter And Related Products, Nesoi",April,2007,Q2,April 2007,-140407979,7567095,147975074
"Printed Matter And Related Products, Nesoi",May,2007,Q2,May 2007,-175491424,10170611,185662035
"Printed Matter And Related Products, Nesoi",June,2007,Q2,June 2007,-194731444,8900339,203631783
"Printed Matter And Related Products, Nesoi",July,2007,Q3,July 2007,-200440578,10584843,211025421
"Printed Matter And Related Products, Nesoi",August,2007,Q3,August 2007,-226074531,10448545,236523076
"Printed Matter And Related Products, Nesoi",September,2007,Q3,September 2007,-217219050,9734966,226954016
"Printed Matter And Related Products, Nesoi",October,2007,Q4,October 2007,-191337849,9432507,200770356
"Printed Matter And Related Products, Nesoi",November,2007,Q4,November 2007,-173678548,10824229,184502777
"Printed Matter And Related Products, Nesoi",December,2007,Q4,December 2007,-150529502,12538326,163067828
"Printed Matter And Related Products, Nesoi",January,2008,Q1,January 2008,-157605355,8186066,165791421
"Printed Matter And Related Products, Nesoi",February,2008,Q1,February 2008,-143047413,9981717,153029130
"Printed Matter And Related Products, Nesoi",March,2008,Q1,March 2008,-101329060,14388396,115717456
"Printed Matter And Related Products, Nesoi",April,2008,Q2,April 2008,-152396955,10837645,163234600
"Printed Matter And Related Products, Nesoi",May,2008,Q2,May 2008,-173291821,13593613,186885434
"Printed Matter And Related Products, Nesoi",June,2008,Q2,June 2008,-198949975,15309853,214259828
"Printed Matter And Related Products, Nesoi",July,2008,Q3,July 2008,-220862692,15313854,236176546
"Printed Matter And Related Products, Nesoi",August,2008,Q3,August 2008,-223729888,13768469,237498357
"Printed Matter And Related Products, Nesoi",September,2008,Q3,September 2008,-225452766,14083385,239536151
"Printed Matter And Related Products, Nesoi",October,2008,Q4,October 2008,-215444844,15628636,231073480
"Printed Matter And Related Products, Nesoi",November,2008,Q4,November 2008,-174154991,14208012,188363003
"Printed Matter And Related Products, Nesoi",December,2008,Q4,December 2008,-148803429,13757837,162561266
"Printed Matter And Related Products, Nesoi",January,2009,Q1,January 2009,-161866472,7871917,169738389
"Printed Matter And Related Products, Nesoi",February,2009,Q1,February 2009,-104597247,7671597,112268844
"Printed Matter And Related Products, Nesoi",March,2009,Q1,March 2009,-115758175,9868173,125626348
"Printed Matter And Related Products, Nesoi",April,2009,Q2,April 2009,-124850987,10341249,135192236
"Printed Matter And Related Products, Nesoi",May,2009,Q2,May 2009,-134490978,8935113,143426091
"Printed Matter And Related Products, Nesoi",June,2009,Q2,June 2009,-166660868,10448131,177108999
"Printed Matter And Related Products, Nesoi",July,2009,Q3,July 2009,-210854748,8983370,219838118
"Printed Matter And Related Products, Nesoi",August,2009,Q3,August 2009,-207911949,9839225,217751174
"Printed Matter And Related Products, Nesoi",September,2009,Q3,September 2009,-195552008,8772052,204324060
"Printed Matter And Related Products, Nesoi",October,2009,Q4,October 2009,-174066837,10560722,184627559
"Printed Matter And Related Products, Nesoi",November,2009,Q4,November 2009,-141721060,10551081,152272141
"Printed Matter And Related Products, Nesoi",December,2009,Q4,December 2009,-143933568,15731624,159665192
"Printed Matter And Related Products, Nesoi",January,2010,Q1,January 2010,-138819103,12567306,151386409
"Printed Matter And Related Products, Nesoi",February,2010,Q1,February 2010,-127214459,10732629,137947088
"Printed Matter And Related Products, Nesoi",March,2010,Q1,March 2010,-113705722,12528234,126233956
"Printed Matter And Related Products, Nesoi",April,2010,Q2,April 2010,-129318530,12406050,141724580
"Printed Matter And Related Products, Nesoi",May,2010,Q2,May 2010,-167390427,16047705,183438132
"Printed Matter And Related Products, Nesoi",June,2010,Q2,June 2010,-217479776,12795621,230275397
"Printed Matter And Related Products, Nesoi",July,2010,Q3,July 2010,-234070950,13281837,247352787
"Printed Matter And Related Products, Nesoi",August,2010,Q3,August 2010,-237558689,12937548,250496237
"Printed Matter And Related Products, Nesoi",September,2010,Q3,September 2010,-224468549,12159016,236627565
"Printed Matter And Related Products, Nesoi",October,2010,Q4,October 2010,-200474039,14098882,214572921
"Printed Matter And Related Products, Nesoi",November,2010,Q4,November 2010,-173245334,11720969,184966303
"Printed Matter And Related Products, Nesoi",December,2010,Q4,December 2010,-150041496,22808510,172850006
"Printed Matter And Related Products, Nesoi",January,2011,Q1,January 2011,-154033191,17190196,171223387
"Printed Matter And Related Products, Nesoi",February,2011,Q1,February 2011,-147330207,10131486,157461693
"Printed Matter And Related Products, Nesoi",March,2011,Q1,March 2011,-93414211,13500120,106914331
"Printed Matter And Related Products, Nesoi",April,2011,Q2,April 2011,-141512349,13373035,154885384
"Printed Matter And Related Products, Nesoi",May,2011,Q2,May 2011,-161141079,14421043,175562122
"Printed Matter And Related Products, Nesoi",June,2011,Q2,June 2011,-202014529,13594165,215608694
"Printed Matter And Related Products, Nesoi",July,2011,Q3,July 2011,-207642612,16877175,224519787
"Printed Matter And Related Products, Nesoi",August,2011,Q3,August 2011,-234676148,14053636,248729784
"Printed Matter And Related Products, Nesoi",September,2011,Q3,September 2011,-221154548,12690689,233845237
"Printed Matter And Related Products, Nesoi",October,2011,Q4,October 2011,-188603281,13262252,201865533
"Printed Matter And Related Products, Nesoi",November,2011,Q4,November 2011,-186544517,13529922,200074439
"Printed Matter And Related Products, Nesoi",December,2011,Q4,December 2011,-161433961,16196456,177630417
"Printed Matter And Related Products, Nesoi",January,2012,Q1,January 2012,-181646475,11862438,193508913
"Printed Matter And Related Products, Nesoi",February,2012,Q1,February 2012,-124415739,13009947,137425686
"Printed Matter And Related Products, Nesoi",March,2012,Q1,March 2012,-123975240,14594969,138570209
"Printed Matter And Related Products, Nesoi",April,2012,Q2,April 2012,-173376365,15327840,188704205
"Printed Matter And Related Products, Nesoi",May,2012,Q2,May 2012,-178551357,15018724,193570081
"Printed Matter And Related Products, Nesoi",June,2012,Q2,June 2012,-216213021,16386046,232599067
"Printed Matter And Related Products, Nesoi",July,2012,Q3,July 2012,-229574729,15351356,244926085
"Printed Matter And Related Products, Nesoi",August,2012,Q3,August 2012,-235695568,16208616,251904184
"Printed Matter And Related Products, Nesoi",September,2012,Q3,September 2012,-228576572,13007495,241584067
"Printed Matter And Related Products, Nesoi",October,2012,Q4,October 2012,-219073657,17309319,236382976
"Printed Matter And Related Products, Nesoi",November,2012,Q4,November 2012,-184820987,13666267,198487254
"Printed Matter And Related Products, Nesoi",December,2012,Q4,December 2012,-168769015,18720277,187489292
"Printed Matter And Related Products, Nesoi",January,2013,Q1,January 2013,-185114579,15378228,200492807
"Printed Matter And Related Products, Nesoi",February,2013,Q1,February 2013,-163092812,11067052,174159864
"Printed Matter And Related Products, Nesoi",March,2013,Q1,March 2013,-102752280,15636351,118388631
"Printed Matter And Related Products, Nesoi",April,2013,Q2,April 2013,-147983751,14375158,162358909
"Printed Matter And Related Products, Nesoi",May,2013,Q2,May 2013,-189813507,15041205,204854712
"Printed Matter And Related Products, Nesoi",June,2013,Q2,June 2013,-223734087,15516702,239250789
"Printed Matter And Related Products, Nesoi",July,2013,Q3,July 2013,-243860963,14249027,258109990
"Printed Matter And Related Products, Nesoi",August,2013,Q3,August 2013,-247009618,17286169,264295787
"Printed Matter And Related Products, Nesoi",September,2013,Q3,September 2013,-231871071,12731824,244602895
"Printed Matter And Related Products, Nesoi",October,2013,Q4,October 2013,-210172320,13235596,223407916
"Printed Matter And Related Products, Nesoi",November,2013,Q4,November 2013,-181301916,15224862,196526778
"Printed Matter And Related Products, Nesoi",December,2013,Q4,December 2013,-176568684,15871463,192440147
"Printed Matter And Related Products, Nesoi",January,2014,Q1,January 2014,-175730172,11858369,187588541
"Printed Matter And Related Products, Nesoi",February,2014,Q1,February 2014,-139611772,17183464,156795236
"Printed Matter And Related Products, Nesoi",March,2014,Q1,March 2014,-114407897,20331921,134739818
"Printed Matter And Related Products, Nesoi",April,2014,Q2,April 2014,-152896592,16525570,169422162
"Printed Matter And Related Products, Nesoi",May,2014,Q2,May 2014,-176562241,18114857,194677098
"Printed Matter And Related Products, Nesoi",June,2014,Q2,June 2014,-222340359,18475104,240815463
"Printed Matter And Related Products, Nesoi",July,2014,Q3,July 2014,-233339187,16964629,250303816
"Printed Matter And Related Products, Nesoi",August,2014,Q3,August 2014,-226165914,17052915,243218829
"Printed Matter And Related Products, Nesoi",September,2014,Q3,September 2014,-241954743,18991997,260946740
"Printed Matter And Related Products, Nesoi",October,2014,Q4,October 2014,-228055829,19143217,247199046
"Printed Matter And Related Products, Nesoi",November,2014,Q4,November 2014,-188485272,17982673,206467945
"Printed Matter And Related Products, Nesoi",December,2014,Q4,December 2014,-158629072,24158639,182787711
"Printed Matter And Related Products, Nesoi",January,2015,Q1,January 2015,-157885344,13824270,171709614
"Printed Matter And Related Products, Nesoi",February,2015,Q1,February 2015,-127328973,14584816,141913789
"Printed Matter And Related Products, Nesoi",March,2015,Q1,March 2015,-188887179,18673445,207560624
"Printed Matter And Related Products, Nesoi",April,2015,Q2,April 2015,-147718805,17782311,165501116
"Printed Matter And Related Products, Nesoi",May,2015,Q2,May 2015,-205188347,18577382,223765729
"Printed Matter And Related Products, Nesoi",June,2015,Q2,June 2015,-241840934,23690409,265531343
"Printed Matter And Related Products, Nesoi",July,2015,Q3,July 2015,-260258384,19523052,279781436
"Printed Matter And Related Products, Nesoi",August,2015,Q3,August 2015,-257139138,19239901,276379039
"Printed Matter And Related Products, Nesoi",September,2015,Q3,September 2015,-245052600,21986391,267038991
"Printed Matter And Related Products, Nesoi",October,2015,Q4,October 2015,-229155159,18999701,248154860
"Printed Matter And Related Products, Nesoi",November,2015,Q4,November 2015,-201164682,18221608,219386290
"Printed Matter And Related Products, Nesoi",December,2015,Q4,December 2015,-174156769,23039550,197196319
"Printed Matter And Related Products, Nesoi",January,2016,Q1,January 2016,-177332158,17345474,194677632
"Printed Matter And Related Products, Nesoi",February,2016,Q1,February 2016,-204365103,11185594,215550697
"Printed Matter And Related Products, Nesoi",March,2016,Q1,March 2016,-111920203,16428889,128349092
"Printed Matter And Related Products, Nesoi",April,2016,Q2,April 2016,-174538298,15720315,190258613
"Printed Matter And Related Products, Nesoi",May,2016,Q2,May 2016,-210363070,14113608,224476678
"Printed Matter And Related Products, Nesoi",June,2016,Q2,June 2016,-225969668,16660739,242630407
"Printed Matter And Related Products, Nesoi",July,2016,Q3,July 2016,-234281920,17184432,251466352
"Printed Matter And Related Products, Nesoi",August,2016,Q3,August 2016,-268195203,16511085,284706288
"Printed Matter And Related Products, Nesoi",September,2016,Q3,September 2016,-262034294,14271307,276305601
"Printed Matter And Related Products, Nesoi",October,2016,Q4,October 2016,-235892061,28728718,264620779
"Printed Matter And Related Products, Nesoi",November,2016,Q4,November 2016,-220417907,12326173,232744080
"Printed Matter And Related Products, Nesoi",December,2016,Q4,December 2016,-184779525,18904765,203684290
"Printed Matter And Related Products, Nesoi",January,2017,Q1,January 2017,-202617103,11988908,214606011
"Printed Matter And Related Products, Nesoi",February,2017,Q1,February 2017,-170385644,13388051,183773695
"Printed Matter And Related Products, Nesoi",March,2017,Q1,March 2017,-129107241,14986526,144093767
"Printed Matter And Related Products, Nesoi",April,2017,Q2,April 2017,-186177083,14891869,201068952
"Printed Matter And Related Products, Nesoi",May,2017,Q2,May 2017,-230758055,15507834,246265889
"Printed Matter And Related Products, Nesoi",June,2017,Q2,June 2017,-265586515,17387440,282973955
"Printed Matter And Related Products, Nesoi",July,2017,Q3,July 2017,-248382531,13340853,261723384
"Printed Matter And Related Products, Nesoi",August,2017,Q3,August 2017,-261403005,15500481,276903486
"Printed Matter And Related Products, Nesoi",September,2017,Q3,September 2017,-266068917,14416778,280485695
"Printed Matter And Related Products, Nesoi",October,2017,Q4,October 2017,-257472749,13820651,271293400
"Printed Matter And Related Products, Nesoi",November,2017,Q4,November 2017,-224775945,13511917,238287862
"Printed Matter And Related Products, Nesoi",December,2017,Q4,December 2017,-199797285,18422906,218220191
"Printed Matter And Related Products, Nesoi",January,2018,Q1,January 2018,-222142001,11797106,233939107
"Printed Matter And Related Products, Nesoi",February,2018,Q1,February 2018,-190083987,10077087,200161074
"Printed Matter And Related Products, Nesoi",March,2018,Q1,March 2018,-153056042,17098581,170154623
"Printed Matter And Related Products, Nesoi",April,2018,Q2,April 2018,-175334337,12701449,188035786
"Printed Matter And Related Products, Nesoi",May,2018,Q2,May 2018,-233046582,17865926,250912508
"Printed Matter And Related Products, Nesoi",June,2018,Q2,June 2018,-245848934,17924774,263773708
"Printed Matter And Related Products, Nesoi",July,2018,Q3,July 2018,-278116713,15494006,293610719
"Printed Matter And Related Products, Nesoi",August,2018,Q3,August 2018,-262343785,15205073,277548858
"Printed Matter And Related Products, Nesoi",September,2018,Q3,September 2018,-295832627,13737540,309570167
"Printed Matter And Related Products, Nesoi",October,2018,Q4,October 2018,-291487665,13667956,305155621
"Printed Matter And Related Products, Nesoi",November,2018,Q4,November 2018,-260693438,12392443,273085881
"Printed Matter And Related Products, Nesoi",December,2018,Q4,December 2018,-220678973,17886297,238565270
"Printed Matter And Related Products, Nesoi",January,2019,Q1,January 2019,-238313401,12238489,250551890
"Printed Matter And Related Products, Nesoi",February,2019,Q1,February 2019,-218063172,10484090,228547262
"Printed Matter And Related Products, Nesoi",March,2019,Q1,March 2019,-158354050,16049093,174403143
"Printed Matter And Related Products, Nesoi",April,2019,Q2,April 2019,-210583415,10790329,221373744
"Printed Matter And Related Products, Nesoi",May,2019,Q2,May 2019,-240770046,13341775,254111821
"Printed Matter And Related Products, Nesoi",June,2019,Q2,June 2019,-274593127,14986123,289579250
"Printed Matter And Related Products, Nesoi",July,2019,Q3,July 2019,-307083113,10886521,317969634
"Printed Matter And Related Products, Nesoi",August,2019,Q3,August 2019,-304344947,16531325,320876272
"Printed Matter And Related Products, Nesoi",September,2019,Q3,September 2019,-283711568,13142432,296854000
"Printed Matter And Related Products, Nesoi",October,2019,Q4,October 2019,-237520725,14270523,251791248
"Printed Matter And Related Products, Nesoi",November,2019,Q4,November 2019,-216647494,12967965,229615459
"Printed Matter And Related Products, Nesoi",December,2019,Q4,December 2019,-196076139,12408894,208485033
Petroleum & Coal Products,January,2002,Q1,January 2002,-8748159,3359169,12107328
Petroleum & Coal Products,February,2002,Q1,February 2002,-1465264,2610913,4076177
Petroleum & Coal Products,March,2002,Q1,March 2002,-9410969,2457549,11868518
Petroleum & Coal Products,April,2002,Q2,April 2002,7892994,13619235,5726241
Petroleum & Coal Products,May,2002,Q2,May 2002,-191734,7457916,7649650
Petroleum & Coal Products,June,2002,Q2,June 2002,-10091335,12603654,22694989
Petroleum & Coal Products,July,2002,Q3,July 2002,-8583953,4007896,12591849
Petroleum & Coal Products,August,2002,Q3,August 2002,-11197507,7452305,18649812
Petroleum & Coal Products,September,2002,Q3,September 2002,8501564,28256745,19755181
Petroleum & Coal Products,October,2002,Q4,October 2002,-5645301,3260563,8905864
Petroleum & Coal Products,November,2002,Q4,November 2002,-6578014,2396853,8974867
Petroleum & Coal Products,December,2002,Q4,December 2002,7426798,11061353,3634555
Petroleum & Coal Products,January,2003,Q1,January 2003,-1172642,7630949,8803591
Petroleum & Coal Products,February,2003,Q1,February 2003,-310822,2554420,2865242
Petroleum & Coal Products,March,2003,Q1,March 2003,-42247332,7216347,49463679
Petroleum & Coal Products,April,2003,Q2,April 2003,-11552779,5745294,17298073
Petroleum & Coal Products,May,2003,Q2,May 2003,-3891235,11777250,15668485
Petroleum & Coal Products,June,2003,Q2,June 2003,-27100816,4542081,31642897
Petroleum & Coal Products,July,2003,Q3,July 2003,-52078555,7783049,59861604
Petroleum & Coal Products,August,2003,Q3,August 2003,-2586269,12894156,15480425
Petroleum & Coal Products,September,2003,Q3,September 2003,-12360292,7464991,19825283
Petroleum & Coal Products,October,2003,Q4,October 2003,4689603,12618625,7929022
Petroleum & Coal Products,November,2003,Q4,November 2003,5803181,14521372,8718191
Petroleum & Coal Products,December,2003,Q4,December 2003,10927260,13369218,2441958
Petroleum & Coal Products,January,2004,Q1,January 2004,-5940691,8745479,14686170
Petroleum & Coal Products,February,2004,Q1,February 2004,-13499294,6127321,19626615
Petroleum & Coal Products,March,2004,Q1,March 2004,-10898779,5699553,16598332
Petroleum & Coal Products,April,2004,Q2,April 2004,-8551587,7373938,15925525
Petroleum & Coal Products,May,2004,Q2,May 2004,-11560404,9782280,21342684
Petroleum & Coal Products,June,2004,Q2,June 2004,-5483938,10043076,15527014
Petroleum & Coal Products,July,2004,Q3,July 2004,-11719025,11271473,22990498
Petroleum & Coal Products,August,2004,Q3,August 2004,-2821063,5452136,8273199
Petroleum & Coal Products,September,2004,Q3,September 2004,3189320,12629020,9439700
Petroleum & Coal Products,October,2004,Q4,October 2004,-2726320,6981110,9707430
Petroleum & Coal Products,November,2004,Q4,November 2004,12548090,28275777,15727687
Petroleum & Coal Products,December,2004,Q4,December 2004,14953458,23744657,8791199
Petroleum & Coal Products,January,2005,Q1,January 2005,-2751326,7226732,9978058
Petroleum & Coal Products,February,2005,Q1,February 2005,-5378238,7784995,13163233
Petroleum & Coal Products,March,2005,Q1,March 2005,21610271,23812025,2201754
Petroleum & Coal Products,April,2005,Q2,April 2005,-3946856,8272819,12219675
Petroleum & Coal Products,May,2005,Q2,May 2005,-6042636,11799107,17841743
Petroleum & Coal Products,June,2005,Q2,June 2005,-19772003,8545546,28317549
Petroleum & Coal Products,July,2005,Q3,July 2005,-7158806,8099843,15258649
Petroleum & Coal Products,August,2005,Q3,August 2005,1151605,8080913,6929308
Petroleum & Coal Products,September,2005,Q3,September 2005,-9296180,14430869,23727049
Petroleum & Coal Products,October,2005,Q4,October 2005,6800629,10992564,4191935
Petroleum & Coal Products,November,2005,Q4,November 2005,7468257,13664938,6196681
Petroleum & Coal Products,December,2005,Q4,December 2005,-19909639,6856669,26766308
Petroleum & Coal Products,January,2006,Q1,January 2006,-14062582,16447023,30509605
Petroleum & Coal Products,February,2006,Q1,February 2006,-8497155,12360194,20857349
Petroleum & Coal Products,March,2006,Q1,March 2006,-7824402,16423128,24247530
Petroleum & Coal Products,April,2006,Q2,April 2006,-17446255,17469871,34916126
Petroleum & Coal Products,May,2006,Q2,May 2006,-38289440,17627534,55916974
Petroleum & Coal Products,June,2006,Q2,June 2006,8089301,31942716,23853415
Petroleum & Coal Products,July,2006,Q3,July 2006,-6271402,11646063,17917465
Petroleum & Coal Products,August,2006,Q3,August 2006,-9600697,11431992,21032689
Petroleum & Coal Products,September,2006,Q3,September 2006,-11201743,6084691,17286434
Petroleum & Coal Products,October,2006,Q4,October 2006,-5642667,13771945,19414612
Petroleum & Coal Products,November,2006,Q4,November 2006,15441375,23371582,7930207
Petroleum & Coal Products,December,2006,Q4,December 2006,1592874,8658386,7065512
Petroleum & Coal Products,January,2007,Q1,January 2007,-15931452,10036240,25967692
Petroleum & Coal Products,February,2007,Q1,February 2007,-7459840,25340104,32799944
Petroleum & Coal Products,March,2007,Q1,March 2007,-2205835,12242695,14448530
Petroleum & Coal Products,April,2007,Q2,April 2007,-5883600,39685608,45569208
Petroleum & Coal Products,May,2007,Q2,May 2007,-16925013,29428233,46353246
Petroleum & Coal Products,June,2007,Q2,June 2007,3324810,22454424,19129614
Petroleum & Coal Products,July,2007,Q3,July 2007,253393,14822886,14569493
Petroleum & Coal Products,August,2007,Q3,August 2007,25591022,43779425,18188403
Petroleum & Coal Products,September,2007,Q3,September 2007,-5334563,16152754,21487317
Petroleum & Coal Products,October,2007,Q4,October 2007,3915488,12498869,8583381
Petroleum & Coal Products,November,2007,Q4,November 2007,4426458,15274965,10848507
Petroleum & Coal Products,December,2007,Q4,December 2007,42681874,54066352,11384478
Petroleum & Coal Products,January,2008,Q1,January 2008,2037649,17154776,15117127
Petroleum & Coal Products,February,2008,Q1,February 2008,-1540183,16610898,18151081
Petroleum & Coal Products,March,2008,Q1,March 2008,46248055,48363782,2115727
Petroleum & Coal Products,April,2008,Q2,April 2008,-14592107,15653940,30246047
Petroleum & Coal Products,May,2008,Q2,May 2008,44644967,93630581,48985614
Petroleum & Coal Products,June,2008,Q2,June 2008,16394729,51272273,34877544
Petroleum & Coal Products,July,2008,Q3,July 2008,22846572,37452682,14606110
Petroleum & Coal Products,August,2008,Q3,August 2008,-38222565,15578084,53800649
Petroleum & Coal Products,September,2008,Q3,September 2008,28800452,48594969,19794517
Petroleum & Coal Products,October,2008,Q4,October 2008,-12140388,18269599,30409987
Petroleum & Coal Products,November,2008,Q4,November 2008,-8945894,27679485,36625379
Petroleum & Coal Products,December,2008,Q4,December 2008,16824978,28588664,11763686
Petroleum & Coal Products,January,2009,Q1,January 2009,-19453358,24277010,43730368
Petroleum & Coal Products,February,2009,Q1,February 2009,24405692,31057140,6651448
Petroleum & Coal Products,March,2009,Q1,March 2009,52052904,63917791,11864887
Petroleum & Coal Products,April,2009,Q2,April 2009,29496666,44928787,15432121
Petroleum & Coal Products,May,2009,Q2,May 2009,38342856,45111236,6768380
Petroleum & Coal Products,June,2009,Q2,June 2009,14005896,24569926,10564030
Petroleum & Coal Products,July,2009,Q3,July 2009,11486767,21024710,9537943
Petroleum & Coal Products,August,2009,Q3,August 2009,-10263405,21914415,32177820
Petroleum & Coal Products,September,2009,Q3,September 2009,2486864,22954204,20467340
Petroleum & Coal Products,October,2009,Q4,October 2009,-18604364,19524453,38128817
Petroleum & Coal Products,November,2009,Q4,November 2009,40316572,45311827,4995255
Petroleum & Coal Products,December,2009,Q4,December 2009,22980594,33297439,10316845
Petroleum & Coal Products,January,2010,Q1,January 2010,24518607,44266877,19748270
Petroleum & Coal Products,February,2010,Q1,February 2010,-18451803,28873845,47325648
Petroleum & Coal Products,March,2010,Q1,March 2010,29461355,69559168,40097813
Petroleum & Coal Products,April,2010,Q2,April 2010,17146761,41985965,24839204
Petroleum & Coal Products,May,2010,Q2,May 2010,46792720,62771854,15979134
Petroleum & Coal Products,June,2010,Q2,June 2010,59552970,87076807,27523837
Petroleum & Coal Products,July,2010,Q3,July 2010,-9044764,25635453,34680217
Petroleum & Coal Products,August,2010,Q3,August 2010,61856126,67453451,5597325
Petroleum & Coal Products,September,2010,Q3,September 2010,12385619,45261411,32875792
Petroleum & Coal Products,October,2010,Q4,October 2010,38212194,40998064,2785870
Petroleum & Coal Products,November,2010,Q4,November 2010,42990718,51452955,8462237
Petroleum & Coal Products,December,2010,Q4,December 2010,71246879,84772869,13525990
Petroleum & Coal Products,January,2011,Q1,January 2011,52885853,59411903,6526050
Petroleum & Coal Products,February,2011,Q1,February 2011,41790540,49332486,7541946
Petroleum & Coal Products,March,2011,Q1,March 2011,39045579,70762380,31716801
Petroleum & Coal Products,April,2011,Q2,April 2011,87660276,96153848,8493572
Petroleum & Coal Products,May,2011,Q2,May 2011,33687124,56311924,22624800
Petroleum & Coal Products,June,2011,Q2,June 2011,82047099,102819599,20772500
Petroleum & Coal Products,July,2011,Q3,July 2011,13020493,51541465,38520972
Petroleum & Coal Products,August,2011,Q3,August 2011,37770121,56729048,18958927
Petroleum & Coal Products,September,2011,Q3,September 2011,41551683,54061952,12510269
Petroleum & Coal Products,October,2011,Q4,October 2011,137747283,160914872,23167589
Petroleum & Coal Products,November,2011,Q4,November 2011,124495274,136614102,12118828
Petroleum & Coal Products,December,2011,Q4,December 2011,146800934,153501996,6701062
Petroleum & Coal Products,January,2012,Q1,January 2012,150608374,164329467,13721093
Petroleum & Coal Products,February,2012,Q1,February 2012,71721201,76367220,4646019
Petroleum & Coal Products,March,2012,Q1,March 2012,39663448,72511968,32848520
Petroleum & Coal Products,April,2012,Q2,April 2012,94079351,110631248,16551897
Petroleum & Coal Products,May,2012,Q2,May 2012,48036598,61663253,13626655
Petroleum & Coal Products,June,2012,Q2,June 2012,56339747,68359536,12019789
Petroleum & Coal Products,July,2012,Q3,July 2012,19282821,35554417,16271596
Petroleum & Coal Products,August,2012,Q3,August 2012,27497540,55550355,28052815
Petroleum & Coal Products,September,2012,Q3,September 2012,22607649,40501927,17894278
Petroleum & Coal Products,October,2012,Q4,October 2012,107253065,121022108,13769043
Petroleum & Coal Products,November,2012,Q4,November 2012,218083948,226492863,8408915
Petroleum & Coal Products,December,2012,Q4,December 2012,43923013,68998215,25075202
Petroleum & Coal Products,January,2013,Q1,January 2013,82790025,97842696,15052671
Petroleum & Coal Products,February,2013,Q1,February 2013,83175154,94628231,11453077
Petroleum & Coal Products,March,2013,Q1,March 2013,46441276,67481630,21040354
Petroleum & Coal Products,April,2013,Q2,April 2013,83171623,97926810,14755187
Petroleum & Coal Products,May,2013,Q2,May 2013,79225673,121108763,41883090
Petroleum & Coal Products,June,2013,Q2,June 2013,57020889,67611167,10590278
Petroleum & Coal Products,July,2013,Q3,July 2013,69347703,115519285,46171582
Petroleum & Coal Products,August,2013,Q3,August 2013,34013987,52546691,18532704
Petroleum & Coal Products,September,2013,Q3,September 2013,39556860,79704927,40148067
Petroleum & Coal Products,October,2013,Q4,October 2013,141982748,203219081,61236333
Petroleum & Coal Products,November,2013,Q4,November 2013,188738004,196849420,8111416
Petroleum & Coal Products,December,2013,Q4,December 2013,253649370,270205849,16556479
Petroleum & Coal Products,January,2014,Q1,January 2014,56039275,83218235,27178960
Petroleum & Coal Products,February,2014,Q1,February 2014,71267258,89466506,18199248
Petroleum & Coal Products,March,2014,Q1,March 2014,46717522,93083659,46366137
Petroleum & Coal Products,April,2014,Q2,April 2014,85162823,102319862,17157039
Petroleum & Coal Products,May,2014,Q2,May 2014,95780330,117641350,21861020
Petroleum & Coal Products,June,2014,Q2,June 2014,26742953,40266954,13524001
Petroleum & Coal Products,July,2014,Q3,July 2014,-22183642,70061916,92245558
Petroleum & Coal Products,August,2014,Q3,August 2014,43154439,131536264,88381825
Petroleum & Coal Products,September,2014,Q3,September 2014,-6459816,24710373,31170189
Petroleum & Coal Products,October,2014,Q4,October 2014,13961861,34652975,20691114
Petroleum & Coal Products,November,2014,Q4,November 2014,56298357,70545064,14246707
Petroleum & Coal Products,December,2014,Q4,December 2014,111993180,150414322,38421142
Petroleum & Coal Products,January,2015,Q1,January 2015,-38241136,40583914,78825050
Petroleum & Coal Products,February,2015,Q1,February 2015,80649593,94117531,13467938
Petroleum & Coal Products,March,2015,Q1,March 2015,43030606,92882645,49852039
Petroleum & Coal Products,April,2015,Q2,April 2015,62853482,88730681,25877199
Petroleum & Coal Products,May,2015,Q2,May 2015,-21213906,40879957,62093863
Petroleum & Coal Products,June,2015,Q2,June 2015,59524192,76570182,17045990
Petroleum & Coal Products,July,2015,Q3,July 2015,79052406,109331434,30279028
Petroleum & Coal Products,August,2015,Q3,August 2015,101358420,119324666,17966246
Petroleum & Coal Products,September,2015,Q3,September 2015,18716517,46077867,27361350
Petroleum & Coal Products,October,2015,Q4,October 2015,1990686,81649126,79658440
Petroleum & Coal Products,November,2015,Q4,November 2015,28597400,78474129,49876729
Petroleum & Coal Products,December,2015,Q4,December 2015,123054337,159145792,36091455
Petroleum & Coal Products,January,2016,Q1,January 2016,35134510,77948389,42813879
Petroleum & Coal Products,February,2016,Q1,February 2016,14492504,40582574,26090070
Petroleum & Coal Products,March,2016,Q1,March 2016,68335887,108285669,39949782
Petroleum & Coal Products,April,2016,Q2,April 2016,21462136,80192757,58730621
Petroleum & Coal Products,May,2016,Q2,May 2016,35735070,78766239,43031169
Petroleum & Coal Products,June,2016,Q2,June 2016,-22938022,25816298,48754320
Petroleum & Coal Products,July,2016,Q3,July 2016,-19784849,27585292,47370141
Petroleum & Coal Products,August,2016,Q3,August 2016,-11316595,38612158,49928753
Petroleum & Coal Products,September,2016,Q3,September 2016,-27929671,58806636,86736307
Petroleum & Coal Products,October,2016,Q4,October 2016,6039071,84425039,78385968
Petroleum & Coal Products,November,2016,Q4,November 2016,111123647,158180755,47057108
Petroleum & Coal Products,December,2016,Q4,December 2016,2344718,55508343,53163625
Petroleum & Coal Products,January,2017,Q1,January 2017,60688404,132149272,71460868
Petroleum & Coal Products,February,2017,Q1,February 2017,65128013,97554510,32426497
Petroleum & Coal Products,March,2017,Q1,March 2017,35264978,83359092,48094114
Petroleum & Coal Products,April,2017,Q2,April 2017,84300556,91386541,7085985
Petroleum & Coal Products,May,2017,Q2,May 2017,101246599,138241993,36995394
Petroleum & Coal Products,June,2017,Q2,June 2017,63209130,124418978,61209848
Petroleum & Coal Products,July,2017,Q3,July 2017,18582768,47563863,28981095
Petroleum & Coal Products,August,2017,Q3,August 2017,-25834026,39277631,65111657
Petroleum & Coal Products,September,2017,Q3,September 2017,-37818188,33781105,71599293
Petroleum & Coal Products,October,2017,Q4,October 2017,68156926,143154155,74997229
Petroleum & Coal Products,November,2017,Q4,November 2017,16110018,114898999,98788981
Petroleum & Coal Products,December,2017,Q4,December 2017,124617935,174951844,50333909
Petroleum & Coal Products,January,2018,Q1,January 2018,50606979,118541129,67934150
Petroleum & Coal Products,February,2018,Q1,February 2018,29859563,87307272,57447709
Petroleum & Coal Products,March,2018,Q1,March 2018,186070755,223199388,37128633
Petroleum & Coal Products,April,2018,Q2,April 2018,92415278,158025303,65610025
Petroleum & Coal Products,May,2018,Q2,May 2018,26352130,104882300,78530170
Petroleum & Coal Products,June,2018,Q2,June 2018,55105946,85398215,30292269
Petroleum & Coal Products,July,2018,Q3,July 2018,3183310,42751132,39567822
Petroleum & Coal Products,August,2018,Q3,August 2018,-30413736,42835548,73249284
Petroleum & Coal Products,September,2018,Q3,September 2018,-79204166,24972862,104177028
Petroleum & Coal Products,October,2018,Q4,October 2018,63830321,80908625,17078304
Petroleum & Coal Products,November,2018,Q4,November 2018,-102423048,26494221,128917269
Petroleum & Coal Products,December,2018,Q4,December 2018,53895233,73727948,19832715
Petroleum & Coal Products,January,2019,Q1,January 2019,37904772,73269083,35364311
Petroleum & Coal Products,February,2019,Q1,February 2019,-2586984,24918103,27505087
Petroleum & Coal Products,March,2019,Q1,March 2019,25621062,46462310,20841248
Petroleum & Coal Products,April,2019,Q2,April 2019,-4179636,17564744,21744380
Petroleum & Coal Products,May,2019,Q2,May 2019,22465592,31771225,9305633
Petroleum & Coal Products,June,2019,Q2,June 2019,81135079,94203157,13068078
Petroleum & Coal Products,July,2019,Q3,July 2019,6775425,26535777,19760352
Petroleum & Coal Products,August,2019,Q3,August 2019,43811096,60275773,16464677
Petroleum & Coal Products,September,2019,Q3,September 2019,-23829298,27043090,50872388
Petroleum & Coal Products,October,2019,Q4,October 2019,17869064,22289238,4420174
Petroleum & Coal Products,November,2019,Q4,November 2019,-16403001,20687712,37090713
Petroleum & Coal Products,December,2019,Q4,December 2019,19422400,45988716,26566316
Chemicals,January,2002,Q1,January 2002,3269181,170070152,166800971
Chemicals,February,2002,Q1,February 2002,45521016,222044177,176523161
Chemicals,March,2002,Q1,March 2002,53687451,199002317,145314866
Chemicals,April,2002,Q2,April 2002,47530757,228209198,180678441
Chemicals,May,2002,Q2,May 2002,76385609,272645546,196259937
Chemicals,June,2002,Q2,June 2002,151328674,309776061,158447387
Chemicals,July,2002,Q3,July 2002,74020618,248499830,174479212
Chemicals,August,2002,Q3,August 2002,95999382,270846909,174847527
Chemicals,September,2002,Q3,September 2002,34835816,195769917,160934101
Chemicals,October,2002,Q4,October 2002,86568246,253618985,167050739
Chemicals,November,2002,Q4,November 2002,132384161,292764075,160379914
Chemicals,December,2002,Q4,December 2002,73820954,316619344,242798390
Chemicals,January,2003,Q1,January 2003,44956234,275983218,231026984
Chemicals,February,2003,Q1,February 2003,138496942,307193715,168696773
Chemicals,March,2003,Q1,March 2003,97282380,293343887,196061507
Chemicals,April,2003,Q2,April 2003,31939122,253708133,221769011
Chemicals,May,2003,Q2,May 2003,-21770347,232233068,254003415
Chemicals,June,2003,Q2,June 2003,93251725,304213261,210961536
Chemicals,July,2003,Q3,July 2003,58346176,271236542,212890366
Chemicals,August,2003,Q3,August 2003,151849550,336028503,184178953
Chemicals,September,2003,Q3,September 2003,136363493,336418879,200055386
Chemicals,October,2003,Q4,October 2003,-42158005,302606119,344764124
Chemicals,November,2003,Q4,November 2003,138798884,349875555,211076671
Chemicals,December,2003,Q4,December 2003,207719735,436217590,228497855
Chemicals,January,2004,Q1,January 2004,107142449,362382421,255239972
Chemicals,February,2004,Q1,February 2004,178822101,384451306,205629205
Chemicals,March,2004,Q1,March 2004,132101415,395091388,262989973
Chemicals,April,2004,Q2,April 2004,62321590,347159359,284837769
Chemicals,May,2004,Q2,May 2004,114368580,401400703,287032123
Chemicals,June,2004,Q2,June 2004,89200018,380854981,291654963
Chemicals,July,2004,Q3,July 2004,64859571,334100815,269241244
Chemicals,August,2004,Q3,August 2004,87032925,388404333,301371408
Chemicals,September,2004,Q3,September 2004,172647287,426438037,253790750
Chemicals,October,2004,Q4,October 2004,75962333,418705432,342743099
Chemicals,November,2004,Q4,November 2004,141421181,463400239,321979058
Chemicals,December,2004,Q4,December 2004,85935157,422172451,336237294
Chemicals,January,2005,Q1,January 2005,15484520,368570599,353086079
Chemicals,February,2005,Q1,February 2005,130277902,462540918,332263016
Chemicals,March,2005,Q1,March 2005,135271996,497816874,362544878
Chemicals,April,2005,Q2,April 2005,56803729,448104674,391300945
Chemicals,May,2005,Q2,May 2005,52171906,507560631,455388725
Chemicals,June,2005,Q2,June 2005,121212223,535045627,413833404
Chemicals,July,2005,Q3,July 2005,159716959,527682819,367965860
Chemicals,August,2005,Q3,August 2005,168896761,540483014,371586253
Chemicals,September,2005,Q3,September 2005,24199686,395391507,371191821
Chemicals,October,2005,Q4,October 2005,-89975223,364588188,454563411
Chemicals,November,2005,Q4,November 2005,-39161258,401241793,440403051
Chemicals,December,2005,Q4,December 2005,89449779,481363754,391913975
Chemicals,January,2006,Q1,January 2006,-41878860,394703027,436581887
Chemicals,February,2006,Q1,February 2006,71425551,465321802,393896251
Chemicals,March,2006,Q1,March 2006,20378859,458827565,438448706
Chemicals,April,2006,Q2,April 2006,25210296,498564472,473354176
Chemicals,May,2006,Q2,May 2006,-44856957,500860810,545717767
Chemicals,June,2006,Q2,June 2006,82079616,518206201,436126585
Chemicals,July,2006,Q3,July 2006,95235023,500467525,405232502
Chemicals,August,2006,Q3,August 2006,55989393,525449681,469460288
Chemicals,September,2006,Q3,September 2006,44802997,483626310,438823313
Chemicals,October,2006,Q4,October 2006,4857793,505709467,500851674
Chemicals,November,2006,Q4,November 2006,103346365,562341280,458994915
Chemicals,December,2006,Q4,December 2006,217357911,650622320,433264409
Chemicals,January,2007,Q1,January 2007,146164720,630913802,484749082
Chemicals,February,2007,Q1,February 2007,162906892,614035035,451128143
Chemicals,March,2007,Q1,March 2007,197504917,662721612,465216695
Chemicals,April,2007,Q2,April 2007,146385862,646129106,499743244
Chemicals,May,2007,Q2,May 2007,65454393,615528783,550074390
Chemicals,June,2007,Q2,June 2007,190747578,682054133,491306555
Chemicals,July,2007,Q3,July 2007,16949697,594177659,577227962
Chemicals,August,2007,Q3,August 2007,191052182,701091810,510039628
Chemicals,September,2007,Q3,September 2007,138834992,635562533,496727541
Chemicals,October,2007,Q4,October 2007,178689195,697935717,519246522
Chemicals,November,2007,Q4,November 2007,-22829302,604184187,627013489
Chemicals,December,2007,Q4,December 2007,162230025,791156531,628926506
Chemicals,January,2008,Q1,January 2008,-264244515,670865660,935110175
Chemicals,February,2008,Q1,February 2008,-79064321,749076648,828140969
Chemicals,March,2008,Q1,March 2008,-23329149,814160646,837489795
Chemicals,April,2008,Q2,April 2008,-134949772,855863154,990812926
Chemicals,May,2008,Q2,May 2008,-302077898,833655992,1135733890
Chemicals,June,2008,Q2,June 2008,-166670066,964552054,1131222120
Chemicals,July,2008,Q3,July 2008,-407968535,775119980,1183088515
Chemicals,August,2008,Q3,August 2008,-283314928,808340547,1091655475
Chemicals,September,2008,Q3,September 2008,-287471378,664290296,951761674
Chemicals,October,2008,Q4,October 2008,-410206434,649092032,1059298466
Chemicals,November,2008,Q4,November 2008,-596659765,489704517,1086364282
Chemicals,December,2008,Q4,December 2008,-518433578,445893494,964327072
Chemicals,January,2009,Q1,January 2009,-558025362,393444058,951469420
Chemicals,February,2009,Q1,February 2009,-195336938,519813903,715150841
Chemicals,March,2009,Q1,March 2009,-268918389,655065305,923983694
Chemicals,April,2009,Q2,April 2009,-102826321,710165312,812991633
Chemicals,May,2009,Q2,May 2009,156334105,974200886,817866781
Chemicals,June,2009,Q2,June 2009,228368935,952460613,724091678
Chemicals,July,2009,Q3,July 2009,242031188,936843072,694811884
Chemicals,August,2009,Q3,August 2009,120681617,916349286,795667669
Chemicals,September,2009,Q3,September 2009,65737836,873852791,808114955
Chemicals,October,2009,Q4,October 2009,-22631061,800841041,823472102
Chemicals,November,2009,Q4,November 2009,22973598,835244789,812271191
Chemicals,December,2009,Q4,December 2009,204074555,1144700272,940625717
Chemicals,January,2010,Q1,January 2010,31057145,944186313,913129168
Chemicals,February,2010,Q1,February 2010,97833867,956369904,858536037
Chemicals,March,2010,Q1,March 2010,-60840366,938901625,999741991
Chemicals,April,2010,Q2,April 2010,-81075408,909462181,990537589
Chemicals,May,2010,Q2,May 2010,6895836,1045664390,1038768554
Chemicals,June,2010,Q2,June 2010,-175098927,955092908,1130191835
Chemicals,July,2010,Q3,July 2010,-172612778,910815910,1083428688
Chemicals,August,2010,Q3,August 2010,-195185655,973345354,1168531009
Chemicals,September,2010,Q3,September 2010,-154473695,917625487,1072099182
Chemicals,October,2010,Q4,October 2010,-97331803,954679486,1052011289
Chemicals,November,2010,Q4,November 2010,25468691,1065691152,1040222461
Chemicals,December,2010,Q4,December 2010,74749021,1231653154,1156904133
Chemicals,January,2011,Q1,January 2011,-188575352,1039345859,1227921211
Chemicals,February,2011,Q1,February 2011,-8645617,1020971500,1029617117
Chemicals,March,2011,Q1,March 2011,-35413835,1139740591,1175154426
Chemicals,April,2011,Q2,April 2011,-81865982,1149357797,1231223779
Chemicals,May,2011,Q2,May 2011,-482446892,1062370837,1544817729
Chemicals,June,2011,Q2,June 2011,-336696519,1082140416,1418836935
Chemicals,July,2011,Q3,July 2011,-200525841,1145222515,1345748356
Chemicals,August,2011,Q3,August 2011,-299754282,1125920294,1425674576
Chemicals,September,2011,Q3,September 2011,-281942059,1154407932,1436349991
Chemicals,October,2011,Q4,October 2011,12734022,1263291311,1250557289
Chemicals,November,2011,Q4,November 2011,-253161703,1104172713,1357334416
Chemicals,December,2011,Q4,December 2011,-8220988,1303714111,1311935099
Chemicals,January,2012,Q1,January 2012,-245502945,1122772486,1368275431
Chemicals,February,2012,Q1,February 2012,-142739296,1049722042,1192461338
Chemicals,March,2012,Q1,March 2012,-51972757,1236035775,1288008532
Chemicals,April,2012,Q2,April 2012,-215723158,1103975176,1319698334
Chemicals,May,2012,Q2,May 2012,-301768866,1153842557,1455611423
Chemicals,June,2012,Q2,June 2012,-311090396,1111297755,1422388151
Chemicals,July,2012,Q3,July 2012,-278237209,1029516590,1307753799
Chemicals,August,2012,Q3,August 2012,-210545652,1059400704,1269946356
Chemicals,September,2012,Q3,September 2012,-270824187,961066137,1231890324
Chemicals,October,2012,Q4,October 2012,-311521330,976210415,1287731745
Chemicals,November,2012,Q4,November 2012,-325842664,977489390,1303332054
Chemicals,December,2012,Q4,December 2012,-149002649,1157783547,1306786196
Chemicals,January,2013,Q1,January 2013,-504136302,992223827,1496360129
Chemicals,February,2013,Q1,February 2013,-222824259,1043630487,1266454746
Chemicals,March,2013,Q1,March 2013,-168051758,1068171245,1236223003
Chemicals,April,2013,Q2,April 2013,-364190666,1077345322,1441535988
Chemicals,May,2013,Q2,May 2013,-296711121,1178738683,1475449804
Chemicals,June,2013,Q2,June 2013,-108788497,1245951587,1354740084
Chemicals,July,2013,Q3,July 2013,-340548597,980940750,1321489347
Chemicals,August,2013,Q3,August 2013,-328510206,1134699241,1463209447
Chemicals,September,2013,Q3,September 2013,-322482209,1026679806,1349162015
Chemicals,October,2013,Q4,October 2013,-34640576,1325413711,1360054287
Chemicals,November,2013,Q4,November 2013,68186003,1328677353,1260491350
Chemicals,December,2013,Q4,December 2013,148719903,1508552592,1359832689
Chemicals,January,2014,Q1,January 2014,-464218606,1118590765,1582809371
Chemicals,February,2014,Q1,February 2014,-159200398,1041195543,1200395941
Chemicals,March,2014,Q1,March 2014,-247080109,1213632753,1460712862
Chemicals,April,2014,Q2,April 2014,-394920113,1170258001,1565178114
Chemicals,May,2014,Q2,May 2014,-365841470,1143605148,1509446618
Chemicals,June,2014,Q2,June 2014,-162400623,1273656118,1436056741
Chemicals,July,2014,Q3,July 2014,-236834838,1143606997,1380441835
Chemicals,August,2014,Q3,August 2014,-310064440,1158782311,1468846751
Chemicals,September,2014,Q3,September 2014,-647950898,1082776276,1730727174
Chemicals,October,2014,Q4,October 2014,-365861884,1160851994,1526713878
Chemicals,November,2014,Q4,November 2014,-225738416,1126072335,1351810751
Chemicals,December,2014,Q4,December 2014,-378461202,1162548990,1541010192
Chemicals,January,2015,Q1,January 2015,-555778468,955797661,1511576129
Chemicals,February,2015,Q1,February 2015,-113619411,1118155538,1231774949
Chemicals,March,2015,Q1,March 2015,-631636911,1138330137,1769967048
Chemicals,April,2015,Q2,April 2015,-509408773,1128515018,1637923791
Chemicals,May,2015,Q2,May 2015,-396613676,1165982102,1562595778
Chemicals,June,2015,Q2,June 2015,-256390988,1203988914,1460379902
Chemicals,July,2015,Q3,July 2015,-159395029,1226126506,1385521535
Chemicals,August,2015,Q3,August 2015,-347436688,1031112661,1378549349
Chemicals,September,2015,Q3,September 2015,-400207382,999558846,1399766228
Chemicals,October,2015,Q4,October 2015,-40457020,1218446970,1258903990
Chemicals,November,2015,Q4,November 2015,-89497219,1113700116,1203197335
Chemicals,December,2015,Q4,December 2015,-298072902,1016080560,1314153462
Chemicals,January,2016,Q1,January 2016,-438372925,965620704,1403993629
Chemicals,February,2016,Q1,February 2016,-270541438,1015588365,1286129803
Chemicals,March,2016,Q1,March 2016,-48511331,1149694020,1198205351
Chemicals,April,2016,Q2,April 2016,-159092918,1192718451,1351811369
Chemicals,May,2016,Q2,May 2016,-351925549,1113924674,1465850223
Chemicals,June,2016,Q2,June 2016,-275432706,1079829085,1355261791
Chemicals,July,2016,Q3,July 2016,-225392487,1100307174,1325699661
Chemicals,August,2016,Q3,August 2016,-365764553,1030349015,1396113568
Chemicals,September,2016,Q3,September 2016,-124481386,1069579763,1194061149
Chemicals,October,2016,Q4,October 2016,-60571650,1170910662,1231482312
Chemicals,November,2016,Q4,November 2016,-263095273,1163425084,1426520357
Chemicals,December,2016,Q4,December 2016,-76591149,1360326645,1436917794
Chemicals,January,2017,Q1,January 2017,-390843103,1211730177,1602573280
Chemicals,February,2017,Q1,February 2017,-90660357,1195670235,1286330592
Chemicals,March,2017,Q1,March 2017,-190158885,1282982034,1473140919
Chemicals,April,2017,Q2,April 2017,-260787535,1176063479,1436851014
Chemicals,May,2017,Q2,May 2017,-200897637,1401680004,1602577641
Chemicals,June,2017,Q2,June 2017,-440888312,1204371789,1645260101
Chemicals,July,2017,Q3,July 2017,-331546502,1149868867,1481415369
Chemicals,August,2017,Q3,August 2017,-407346536,1127243517,1534590053
Chemicals,September,2017,Q3,September 2017,-324518813,1132057221,1456576034
Chemicals,October,2017,Q4,October 2017,-213890944,1262285398,1476176342
Chemicals,November,2017,Q4,November 2017,-23341708,1433627730,1456969438
Chemicals,December,2017,Q4,December 2017,-138028606,1571758950,1709787556
Chemicals,January,2018,Q1,January 2018,-663155092,1242579551,1905734643
Chemicals,February,2018,Q1,February 2018,-329921576,1311453338,1641374914
Chemicals,March,2018,Q1,March 2018,-382216494,1372486981,1754703475
Chemicals,April,2018,Q2,April 2018,-446041544,1344141888,1790183432
Chemicals,May,2018,Q2,May 2018,-463678203,1482759364,1946437567
Chemicals,June,2018,Q2,June 2018,-312488343,1477195709,1789684052
Chemicals,July,2018,Q3,July 2018,-342164099,1387574640,1729738739
Chemicals,August,2018,Q3,August 2018,-301292388,1493871450,1795163838
Chemicals,September,2018,Q3,September 2018,-448956312,1273557322,1722513634
Chemicals,October,2018,Q4,October 2018,-399941750,1304351261,1704293011
Chemicals,November,2018,Q4,November 2018,-428596002,1182396604,1610992606
Chemicals,December,2018,Q4,December 2018,-757997689,1216409336,1974407025
Chemicals,January,2019,Q1,January 2019,-349093281,1282323773,1631417054
Chemicals,February,2019,Q1,February 2019,-244899942,1106356686,1351256628
Chemicals,March,2019,Q1,March 2019,359495613,1788043397,1428547784
Chemicals,April,2019,Q2,April 2019,-271295632,1226933342,1498228974
Chemicals,May,2019,Q2,May 2019,-212081813,1303227716,1515309529
Chemicals,June,2019,Q2,June 2019,-139297219,1280464684,1419761903
Chemicals,July,2019,Q3,July 2019,-246234203,1207248665,1453482868
Chemicals,August,2019,Q3,August 2019,-77946827,1235452311,1313399138
Chemicals,September,2019,Q3,September 2019,54366021,1332855672,1278489651
Chemicals,October,2019,Q4,October 2019,298071938,1489739847,1191667909
Chemicals,November,2019,Q4,November 2019,230356253,1316963007,1086606754
Chemicals,December,2019,Q4,December 2019,219358316,1432440777,1213082461
Plastics & Rubber Products,January,2002,Q1,January 2002,-243234989,13003153,256238142
Plastics & Rubber Products,February,2002,Q1,February 2002,-238096133,15584235,253680368
Plastics & Rubber Products,March,2002,Q1,March 2002,-211807630,17113844,228921474
Plastics & Rubber Products,April,2002,Q2,April 2002,-278082106,18231592,296313698
Plastics & Rubber Products,May,2002,Q2,May 2002,-298493018,19429655,317922673
Plastics & Rubber Products,June,2002,Q2,June 2002,-285878083,21756988,307635071
Plastics & Rubber Products,July,2002,Q3,July 2002,-275553712,20560415,296114127
Plastics & Rubber Products,August,2002,Q3,August 2002,-283766049,21608614,305374663
Plastics & Rubber Products,September,2002,Q3,September 2002,-278977971,18539274,297517245
Plastics & Rubber Products,October,2002,Q4,October 2002,-226676939,19965860,246642799
Plastics & Rubber Products,November,2002,Q4,November 2002,-242732234,22829078,265561312
Plastics & Rubber Products,December,2002,Q4,December 2002,-307310315,20331627,327641942
Plastics & Rubber Products,January,2003,Q1,January 2003,-325080047,23910406,348990453
Plastics & Rubber Products,February,2003,Q1,February 2003,-276343912,24267361,300611273
Plastics & Rubber Products,March,2003,Q1,March 2003,-280952650,24716075,305668725
Plastics & Rubber Products,April,2003,Q2,April 2003,-342364209,21813459,364177668
Plastics & Rubber Products,May,2003,Q2,May 2003,-330416205,21280397,351696602
Plastics & Rubber Products,June,2003,Q2,June 2003,-296308542,23191887,319500429
Plastics & Rubber Products,July,2003,Q3,July 2003,-307863227,22617394,330480621
Plastics & Rubber Products,August,2003,Q3,August 2003,-300251737,24379308,324631045
Plastics & Rubber Products,September,2003,Q3,September 2003,-299000158,22782830,321782988
Plastics & Rubber Products,October,2003,Q4,October 2003,-311119713,28648384,339768097
Plastics & Rubber Products,November,2003,Q4,November 2003,-292185117,28978855,321163972
Plastics & Rubber Products,December,2003,Q4,December 2003,-315979398,27925132,343904530
Plastics & Rubber Products,January,2004,Q1,January 2004,-349575449,33193649,382769098
Plastics & Rubber Products,February,2004,Q1,February 2004,-277621533,31467294,309088827
Plastics & Rubber Products,March,2004,Q1,March 2004,-355829253,41515674,397344927
Plastics & Rubber Products,April,2004,Q2,April 2004,-379969849,37114630,417084479
Plastics & Rubber Products,May,2004,Q2,May 2004,-395429393,36633753,432063146
Plastics & Rubber Products,June,2004,Q2,June 2004,-417504989,33042798,450547787
Plastics & Rubber Products,July,2004,Q3,July 2004,-388106355,39058873,427165228
Plastics & Rubber Products,August,2004,Q3,August 2004,-391440060,31511558,422951618
Plastics & Rubber Products,September,2004,Q3,September 2004,-391183945,29700205,420884150
Plastics & Rubber Products,October,2004,Q4,October 2004,-384442115,35900945,420343060
Plastics & Rubber Products,November,2004,Q4,November 2004,-430903261,32796171,463699432
Plastics & Rubber Products,December,2004,Q4,December 2004,-457696516,34280816,491977332
Plastics & Rubber Products,January,2005,Q1,January 2005,-500007971,30242174,530250145
Plastics & Rubber Products,February,2005,Q1,February 2005,-459166870,35054437,494221307
Plastics & Rubber Products,March,2005,Q1,March 2005,-437252536,38491670,475744206
Plastics & Rubber Products,April,2005,Q2,April 2005,-513887013,38751909,552638922
Plastics & Rubber Products,May,2005,Q2,May 2005,-535033169,38356965,573390134
Plastics & Rubber Products,June,2005,Q2,June 2005,-555016479,39649881,594666360
Plastics & Rubber Products,July,2005,Q3,July 2005,-521503436,40404304,561907740
Plastics & Rubber Products,August,2005,Q3,August 2005,-535483793,47061361,582545154
Plastics & Rubber Products,September,2005,Q3,September 2005,-522834746,41007378,563842124
Plastics & Rubber Products,October,2005,Q4,October 2005,-535539587,37216882,572756469
Plastics & Rubber Products,November,2005,Q4,November 2005,-517166000,40587044,557753044
Plastics & Rubber Products,December,2005,Q4,December 2005,-542756454,35759670,578516124
Plastics & Rubber Products,January,2006,Q1,January 2006,-612382471,35123576,647506047
Plastics & Rubber Products,February,2006,Q1,February 2006,-499540684,35552433,535093117
Plastics & Rubber Products,March,2006,Q1,March 2006,-542702781,44419691,587122472
Plastics & Rubber Products,April,2006,Q2,April 2006,-630754013,41232357,671986370
Plastics & Rubber Products,May,2006,Q2,May 2006,-673321735,49803921,723125656
Plastics & Rubber Products,June,2006,Q2,June 2006,-648407943,49040558,697448501
Plastics & Rubber Products,July,2006,Q3,July 2006,-625846270,48472782,674319052
Plastics & Rubber Products,August,2006,Q3,August 2006,-643923378,48185877,692109255
Plastics & Rubber Products,September,2006,Q3,September 2006,-601144464,48793328,649937792
Plastics & Rubber Products,October,2006,Q4,October 2006,-627297283,48549540,675846823
Plastics & Rubber Products,November,2006,Q4,November 2006,-635433661,45698576,681132237
Plastics & Rubber Products,December,2006,Q4,December 2006,-605585402,51012028,656597430
Plastics & Rubber Products,January,2007,Q1,January 2007,-690066763,49189754,739256517
Plastics & Rubber Products,February,2007,Q1,February 2007,-645546898,49624248,695171146
Plastics & Rubber Products,March,2007,Q1,March 2007,-584898314,60511749,645410063
Plastics & Rubber Products,April,2007,Q2,April 2007,-704012902,51546870,755559772
Plastics & Rubber Products,May,2007,Q2,May 2007,-796032117,55518066,851550183
Plastics & Rubber Products,June,2007,Q2,June 2007,-789521179,53966027,843487206
Plastics & Rubber Products,July,2007,Q3,July 2007,-813350976,52370650,865721626
Plastics & Rubber Products,August,2007,Q3,August 2007,-739710422,59230995,798941417
Plastics & Rubber Products,September,2007,Q3,September 2007,-708519016,55989951,764508967
Plastics & Rubber Products,October,2007,Q4,October 2007,-711095449,59506982,770602431
Plastics & Rubber Products,November,2007,Q4,November 2007,-751104567,57120695,808225262
Plastics & Rubber Products,December,2007,Q4,December 2007,-701180565,59891705,761072270
Plastics & Rubber Products,January,2008,Q1,January 2008,-758538955,51260672,809799627
Plastics & Rubber Products,February,2008,Q1,February 2008,-712726005,62304914,775030919
Plastics & Rubber Products,March,2008,Q1,March 2008,-600988424,66066696,667055120
Plastics & Rubber Products,April,2008,Q2,April 2008,-759035435,74627704,833663139
Plastics & Rubber Products,May,2008,Q2,May 2008,-820672095,70881609,891553704
Plastics & Rubber Products,June,2008,Q2,June 2008,-773497751,66182337,839680088
Plastics & Rubber Products,July,2008,Q3,July 2008,-801953176,73563276,875516452
Plastics & Rubber Products,August,2008,Q3,August 2008,-793186261,79836134,873022395
Plastics & Rubber Products,September,2008,Q3,September 2008,-838016523,71627625,909644148
Plastics & Rubber Products,October,2008,Q4,October 2008,-818884314,66701662,885585976
Plastics & Rubber Products,November,2008,Q4,November 2008,-804349627,54327673,858677300
Plastics & Rubber Products,December,2008,Q4,December 2008,-788488737,45685578,834174315
Plastics & Rubber Products,January,2009,Q1,January 2009,-779249578,38949542,818199120
Plastics & Rubber Products,February,2009,Q1,February 2009,-548841625,39843754,588685379
Plastics & Rubber Products,March,2009,Q1,March 2009,-606579767,53844401,660424168
Plastics & Rubber Products,April,2009,Q2,April 2009,-678857924,54250749,733108673
Plastics & Rubber Products,May,2009,Q2,May 2009,-680409318,83713572,764122890
Plastics & Rubber Products,June,2009,Q2,June 2009,-715192045,59696047,774888092
Plastics & Rubber Products,July,2009,Q3,July 2009,-756624277,61870744,818495021
Plastics & Rubber Products,August,2009,Q3,August 2009,-733266905,68966218,802233123
Plastics & Rubber Products,September,2009,Q3,September 2009,-739618164,59292652,798910816
Plastics & Rubber Products,October,2009,Q4,October 2009,-646031981,65135077,711167058
Plastics & Rubber Products,November,2009,Q4,November 2009,-609227896,72094775,681322671
Plastics & Rubber Products,December,2009,Q4,December 2009,-666453562,74706080,741159642
Plastics & Rubber Products,January,2010,Q1,January 2010,-706997955,71696626,778694581
Plastics & Rubber Products,February,2010,Q1,February 2010,-624307847,77250255,701558102
Plastics & Rubber Products,March,2010,Q1,March 2010,-626069936,90801526,716871462
Plastics & Rubber Products,April,2010,Q2,April 2010,-714118490,82454913,796573403
Plastics & Rubber Products,May,2010,Q2,May 2010,-803769902,93923378,897693280
Plastics & Rubber Products,June,2010,Q2,June 2010,-916924947,84910358,1001835305
Plastics & Rubber Products,July,2010,Q3,July 2010,-926212298,86984161,1013196459
Plastics & Rubber Products,August,2010,Q3,August 2010,-911578749,91435171,1003013920
Plastics & Rubber Products,September,2010,Q3,September 2010,-844612337,74626892,919239229
Plastics & Rubber Products,October,2010,Q4,October 2010,-803111037,92127176,895238213
Plastics & Rubber Products,November,2010,Q4,November 2010,-786880030,87768984,874649014
Plastics & Rubber Products,December,2010,Q4,December 2010,-773024215,91022210,864046425
Plastics & Rubber Products,January,2011,Q1,January 2011,-915127634,84063000,999190634
Plastics & Rubber Products,February,2011,Q1,February 2011,-781121518,92188720,873310238
Plastics & Rubber Products,March,2011,Q1,March 2011,-646621587,117243083,763864670
Plastics & Rubber Products,April,2011,Q2,April 2011,-858003899,116822728,974826627
Plastics & Rubber Products,May,2011,Q2,May 2011,-956245383,110380913,1066626296
Plastics & Rubber Products,June,2011,Q2,June 2011,-1007031527,98916589,1105948116
Plastics & Rubber Products,July,2011,Q3,July 2011,-985724693,101630489,1087355182
Plastics & Rubber Products,August,2011,Q3,August 2011,-1007262452,93475661,1100738113
Plastics & Rubber Products,September,2011,Q3,September 2011,-893099246,114551877,1007651123
Plastics & Rubber Products,October,2011,Q4,October 2011,-855602628,115175591,970778219
Plastics & Rubber Products,November,2011,Q4,November 2011,-923472017,90081117,1013553134
Plastics & Rubber Products,December,2011,Q4,December 2011,-929646935,90823135,1020470070
Plastics & Rubber Products,January,2012,Q1,January 2012,-1187226871,75808973,1263035844
Plastics & Rubber Products,February,2012,Q1,February 2012,-884595263,83662345,968257608
Plastics & Rubber Products,March,2012,Q1,March 2012,-941674471,110492998,1052167469
Plastics & Rubber Products,April,2012,Q2,April 2012,-1180910033,98858690,1279768723
Plastics & Rubber Products,May,2012,Q2,May 2012,-1207931486,113456873,1321388359
Plastics & Rubber Products,June,2012,Q2,June 2012,-1205334703,111490478,1316825181
Plastics & Rubber Products,July,2012,Q3,July 2012,-1246197680,89300174,1335497854
Plastics & Rubber Products,August,2012,Q3,August 2012,-1137826616,95404867,1233231483
Plastics & Rubber Products,September,2012,Q3,September 2012,-1112563757,90289913,1202853670
Plastics & Rubber Products,October,2012,Q4,October 2012,-1202597601,82790587,1285388188
Plastics & Rubber Products,November,2012,Q4,November 2012,-1143320714,87066297,1230387011
Plastics & Rubber Products,December,2012,Q4,December 2012,-1124425554,93734432,1218159986
Plastics & Rubber Products,January,2013,Q1,January 2013,-1319734584,82371350,1402105934
Plastics & Rubber Products,February,2013,Q1,February 2013,-1151358170,83294686,1234652856
Plastics & Rubber Products,March,2013,Q1,March 2013,-867389961,106800093,974190054
Plastics & Rubber Products,April,2013,Q2,April 2013,-1235032472,93269719,1328302191
Plastics & Rubber Products,May,2013,Q2,May 2013,-1335108751,109169890,1444278641
Plastics & Rubber Products,June,2013,Q2,June 2013,-1311435559,114538334,1425973893
Plastics & Rubber Products,July,2013,Q3,July 2013,-1332022220,95370448,1427392668
Plastics & Rubber Products,August,2013,Q3,August 2013,-1255659881,127119801,1382779682
Plastics & Rubber Products,September,2013,Q3,September 2013,-1234357859,100350671,1334708530
Plastics & Rubber Products,October,2013,Q4,October 2013,-1250041511,106260168,1356301679
Plastics & Rubber Products,November,2013,Q4,November 2013,-1174286055,98400839,1272686894
Plastics & Rubber Products,December,2013,Q4,December 2013,-1241942446,93058350,1335000796
Plastics & Rubber Products,January,2014,Q1,January 2014,-1408235367,87191775,1495427142
Plastics & Rubber Products,February,2014,Q1,February 2014,-1125421776,86389320,1211811096
Plastics & Rubber Products,March,2014,Q1,March 2014,-1086547441,111013489,1197560930
Plastics & Rubber Products,April,2014,Q2,April 2014,-1314070332,105902308,1419972640
Plastics & Rubber Products,May,2014,Q2,May 2014,-1394851355,113577799,1508429154
Plastics & Rubber Products,June,2014,Q2,June 2014,-1445566688,111960290,1557526978
Plastics & Rubber Products,July,2014,Q3,July 2014,-1430316436,113398323,1543714759
Plastics & Rubber Products,August,2014,Q3,August 2014,-1345109427,111728650,1456838077
Plastics & Rubber Products,September,2014,Q3,September 2014,-1394051258,100531960,1494583218
Plastics & Rubber Products,October,2014,Q4,October 2014,-1357390249,112757384,1470147633
Plastics & Rubber Products,November,2014,Q4,November 2014,-1212987909,100377097,1313365006
Plastics & Rubber Products,December,2014,Q4,December 2014,-1192658129,102607332,1295265461
Plastics & Rubber Products,January,2015,Q1,January 2015,-1272409550,91505398,1363914948
Plastics & Rubber Products,February,2015,Q1,February 2015,-1007387117,94633557,1102020674
Plastics & Rubber Products,March,2015,Q1,March 2015,-1342914675,123789445,1466704120
Plastics & Rubber Products,April,2015,Q2,April 2015,-1246912923,114120519,1361033442
Plastics & Rubber Products,May,2015,Q2,May 2015,-1407496813,104744470,1512241283
Plastics & Rubber Products,June,2015,Q2,June 2015,-1407652075,117174684,1524826759
Plastics & Rubber Products,July,2015,Q3,July 2015,-1412945465,105076074,1518021539
Plastics & Rubber Products,August,2015,Q3,August 2015,-1304229028,122888580,1427117608
Plastics & Rubber Products,September,2015,Q3,September 2015,-1243540322,113663034,1357203356
Plastics & Rubber Products,October,2015,Q4,October 2015,-1121665376,117343288,1239008664
Plastics & Rubber Products,November,2015,Q4,November 2015,-1123538756,112466574,1236005330
Plastics & Rubber Products,December,2015,Q4,December 2015,-1163809651,126403733,1290213384
Plastics & Rubber Products,January,2016,Q1,January 2016,-1268721975,96321980,1365043955
Plastics & Rubber Products,February,2016,Q1,February 2016,-1285711764,106054655,1391766419
Plastics & Rubber Products,March,2016,Q1,March 2016,-904534080,127168858,1031702938
Plastics & Rubber Products,April,2016,Q2,April 2016,-1167789835,116560480,1284350315
Plastics & Rubber Products,May,2016,Q2,May 2016,-1314591405,115764925,1430356330
Plastics & Rubber Products,June,2016,Q2,June 2016,-1283509637,123933695,1407443332
Plastics & Rubber Products,July,2016,Q3,July 2016,-1177988090,109059818,1287047908
Plastics & Rubber Products,August,2016,Q3,August 2016,-1317724395,108259617,1425984012
Plastics & Rubber Products,September,2016,Q3,September 2016,-1110849670,108570461,1219420131
Plastics & Rubber Products,October,2016,Q4,October 2016,-1121560977,124638978,1246199955
Plastics & Rubber Products,November,2016,Q4,November 2016,-1192778728,128955511,1321734239
Plastics & Rubber Products,December,2016,Q4,December 2016,-1264461427,142244213,1406705640
Plastics & Rubber Products,January,2017,Q1,January 2017,-1379495750,108604103,1488099853
Plastics & Rubber Products,February,2017,Q1,February 2017,-1061475618,127173757,1188649375
Plastics & Rubber Products,March,2017,Q1,March 2017,-1001151177,151335738,1152486915
Plastics & Rubber Products,April,2017,Q2,April 2017,-1203630146,144459401,1348089547
Plastics & Rubber Products,May,2017,Q2,May 2017,-1385497094,146104001,1531601095
Plastics & Rubber Products,June,2017,Q2,June 2017,-1380088750,150018576,1530107326
Plastics & Rubber Products,July,2017,Q3,July 2017,-1394951964,137503945,1532455909
Plastics & Rubber Products,August,2017,Q3,August 2017,-1377558497,142366911,1519925408
Plastics & Rubber Products,September,2017,Q3,September 2017,-1296211163,130743462,1426954625
Plastics & Rubber Products,October,2017,Q4,October 2017,-1328875734,136908939,1465784673
Plastics & Rubber Products,November,2017,Q4,November 2017,-1299927449,135769892,1435697341
Plastics & Rubber Products,December,2017,Q4,December 2017,-1396983929,147244941,1544228870
Plastics & Rubber Products,January,2018,Q1,January 2018,-1607320939,113181084,1720502023
Plastics & Rubber Products,February,2018,Q1,February 2018,-1425490689,125010747,1550501436
Plastics & Rubber Products,March,2018,Q1,March 2018,-1191870562,149111666,1340982228
Plastics & Rubber Products,April,2018,Q2,April 2018,-1284652658,147917583,1432570241
Plastics & Rubber Products,May,2018,Q2,May 2018,-1584911968,148692561,1733604529
Plastics & Rubber Products,June,2018,Q2,June 2018,-1631910280,149514500,1781424780
Plastics & Rubber Products,July,2018,Q3,July 2018,-1631288610,158111938,1789400548
Plastics & Rubber Products,August,2018,Q3,August 2018,-1605639112,137042283,1742681395
Plastics & Rubber Products,September,2018,Q3,September 2018,-1525158815,127542003,1652700818
Plastics & Rubber Products,October,2018,Q4,October 2018,-1688911327,135661024,1824572351
Plastics & Rubber Products,November,2018,Q4,November 2018,-1532686902,126763764,1659450666
Plastics & Rubber Products,December,2018,Q4,December 2018,-1867036009,123933246,1990969255
Plastics & Rubber Products,January,2019,Q1,January 2019,-1737368744,109099010,1846467754
Plastics & Rubber Products,February,2019,Q1,February 2019,-1398808323,119582903,1518391226
Plastics & Rubber Products,March,2019,Q1,March 2019,-1061828896,139719105,1201548001
Plastics & Rubber Products,April,2019,Q2,April 2019,-1324568270,123313120,1447881390
Plastics & Rubber Products,May,2019,Q2,May 2019,-1552066125,137899516,1689965641
Plastics & Rubber Products,June,2019,Q2,June 2019,-1409946503,136161937,1546108440
Plastics & Rubber Products,July,2019,Q3,July 2019,-1555335241,121268716,1676603957
Plastics & Rubber Products,August,2019,Q3,August 2019,-1545447637,127681422,1673129059
Plastics & Rubber Products,September,2019,Q3,September 2019,-1407268160,116995161,1524263321
Plastics & Rubber Products,October,2019,Q4,October 2019,-1341625992,126453921,1468079913
Plastics & Rubber Products,November,2019,Q4,November 2019,-1223444784,133747242,1357192026
Plastics & Rubber Products,December,2019,Q4,December 2019,-1333788188,122889476,1456677664
Nonmetallic Mineral Products,January,2002,Q1,January 2002,-185938665,10357377,196296042
Nonmetallic Mineral Products,February,2002,Q1,February 2002,-195006794,9607086,204613880
Nonmetallic Mineral Products,March,2002,Q1,March 2002,-148348960,9083939,157432899
Nonmetallic Mineral Products,April,2002,Q2,April 2002,-199417524,14219855,213637379
Nonmetallic Mineral Products,May,2002,Q2,May 2002,-205743265,13991133,219734398
Nonmetallic Mineral Products,June,2002,Q2,June 2002,-224457918,12421118,236879036
Nonmetallic Mineral Products,July,2002,Q3,July 2002,-233590636,14603596,248194232
Nonmetallic Mineral Products,August,2002,Q3,August 2002,-279349557,17292593,296642150
Nonmetallic Mineral Products,September,2002,Q3,September 2002,-283325976,10286650,293612626
Nonmetallic Mineral Products,October,2002,Q4,October 2002,-231931895,12502103,244433998
Nonmetallic Mineral Products,November,2002,Q4,November 2002,-232512069,13232209,245744278
Nonmetallic Mineral Products,December,2002,Q4,December 2002,-262510533,11583494,274094027
Nonmetallic Mineral Products,January,2003,Q1,January 2003,-257777497,11955726,269733223
Nonmetallic Mineral Products,February,2003,Q1,February 2003,-213913349,13685664,227599013
Nonmetallic Mineral Products,March,2003,Q1,March 2003,-182383101,20180080,202563181
Nonmetallic Mineral Products,April,2003,Q2,April 2003,-216945265,14164270,231109535
Nonmetallic Mineral Products,May,2003,Q2,May 2003,-223011193,14129828,237141021
Nonmetallic Mineral Products,June,2003,Q2,June 2003,-222953222,12718410,235671632
Nonmetallic Mineral Products,July,2003,Q3,July 2003,-250126669,15556146,265682815
Nonmetallic Mineral Products,August,2003,Q3,August 2003,-268871324,16340732,285212056
Nonmetallic Mineral Products,September,2003,Q3,September 2003,-280115957,14997570,295113527
Nonmetallic Mineral Products,October,2003,Q4,October 2003,-273303424,15361755,288665179
Nonmetallic Mineral Products,November,2003,Q4,November 2003,-228830650,13372653,242203303
Nonmetallic Mineral Products,December,2003,Q4,December 2003,-225262574,13005249,238267823
Nonmetallic Mineral Products,January,2004,Q1,January 2004,-268466472,13044217,281510689
Nonmetallic Mineral Products,February,2004,Q1,February 2004,-181656162,19311329,200967491
Nonmetallic Mineral Products,March,2004,Q1,March 2004,-211850895,23868983,235719878
Nonmetallic Mineral Products,April,2004,Q2,April 2004,-227087046,25527745,252614791
Nonmetallic Mineral Products,May,2004,Q2,May 2004,-227368004,22277655,249645659
Nonmetallic Mineral Products,June,2004,Q2,June 2004,-266853618,18849155,285702773
Nonmetallic Mineral Products,July,2004,Q3,July 2004,-292970210,19360584,312330794
Nonmetallic Mineral Products,August,2004,Q3,August 2004,-311717960,17271503,328989463
Nonmetallic Mineral Products,September,2004,Q3,September 2004,-328786394,18131467,346917861
Nonmetallic Mineral Products,October,2004,Q4,October 2004,-287585705,17974906,305560611
Nonmetallic Mineral Products,November,2004,Q4,November 2004,-306931832,18899846,325831678
Nonmetallic Mineral Products,December,2004,Q4,December 2004,-272357215,21536245,293893460
Nonmetallic Mineral Products,January,2005,Q1,January 2005,-311646737,12902692,324549429
Nonmetallic Mineral Products,February,2005,Q1,February 2005,-277995710,17201243,295196953
Nonmetallic Mineral Products,March,2005,Q1,March 2005,-252348971,21798390,274147361
Nonmetallic Mineral Products,April,2005,Q2,April 2005,-257237160,19380213,276617373
Nonmetallic Mineral Products,May,2005,Q2,May 2005,-295116122,17735221,312851343
Nonmetallic Mineral Products,June,2005,Q2,June 2005,-326258926,18357493,344616419
Nonmetallic Mineral Products,July,2005,Q3,July 2005,-362150730,18800761,380951491
Nonmetallic Mineral Products,August,2005,Q3,August 2005,-381560990,32339388,413900378
Nonmetallic Mineral Products,September,2005,Q3,September 2005,-372323223,19717323,392040546
Nonmetallic Mineral Products,October,2005,Q4,October 2005,-375946807,21199779,397146586
Nonmetallic Mineral Products,November,2005,Q4,November 2005,-324524572,18691139,343215711
Nonmetallic Mineral Products,December,2005,Q4,December 2005,-329125214,22467086,351592300
Nonmetallic Mineral Products,January,2006,Q1,January 2006,-348810600,22622564,371433164
Nonmetallic Mineral Products,February,2006,Q1,February 2006,-306580163,21064600,327644763
Nonmetallic Mineral Products,March,2006,Q1,March 2006,-316255031,30022419,346277450
Nonmetallic Mineral Products,April,2006,Q2,April 2006,-370332213,25471490,395803703
Nonmetallic Mineral Products,May,2006,Q2,May 2006,-394275377,26080478,420355855
Nonmetallic Mineral Products,June,2006,Q2,June 2006,-406595209,23642495,430237704
Nonmetallic Mineral Products,July,2006,Q3,July 2006,-428301324,24494550,452795874
Nonmetallic Mineral Products,August,2006,Q3,August 2006,-469014267,30378848,499393115
Nonmetallic Mineral Products,September,2006,Q3,September 2006,-449684206,28798976,478483182
Nonmetallic Mineral Products,October,2006,Q4,October 2006,-429693060,37467005,467160065
Nonmetallic Mineral Products,November,2006,Q4,November 2006,-376326716,25054618,401381334
Nonmetallic Mineral Products,December,2006,Q4,December 2006,-347791604,30410825,378202429
Nonmetallic Mineral Products,January,2007,Q1,January 2007,-397388326,30098770,427487096
Nonmetallic Mineral Products,February,2007,Q1,February 2007,-357667982,29080081,386748063
Nonmetallic Mineral Products,March,2007,Q1,March 2007,-309798823,32697725,342496548
Nonmetallic Mineral Products,April,2007,Q2,April 2007,-304412338,32553884,336966222
Nonmetallic Mineral Products,May,2007,Q2,May 2007,-397116210,38251719,435367929
Nonmetallic Mineral Products,June,2007,Q2,June 2007,-398060457,41073342,439133799
Nonmetallic Mineral Products,July,2007,Q3,July 2007,-434012230,37342956,471355186
Nonmetallic Mineral Products,August,2007,Q3,August 2007,-441422833,42392187,483815020
Nonmetallic Mineral Products,September,2007,Q3,September 2007,-459301467,31189167,490490634
Nonmetallic Mineral Products,October,2007,Q4,October 2007,-423224462,43387240,466611702
Nonmetallic Mineral Products,November,2007,Q4,November 2007,-390258089,36338967,426597056
Nonmetallic Mineral Products,December,2007,Q4,December 2007,-360697237,46045878,406743115
Nonmetallic Mineral Products,January,2008,Q1,January 2008,-399997589,38061542,438059131
Nonmetallic Mineral Products,February,2008,Q1,February 2008,-343171196,34169554,377340750
Nonmetallic Mineral Products,March,2008,Q1,March 2008,-284389436,42651073,327040509
Nonmetallic Mineral Products,April,2008,Q2,April 2008,-299154583,47345205,346499788
Nonmetallic Mineral Products,May,2008,Q2,May 2008,-374575854,50265307,424841161
Nonmetallic Mineral Products,June,2008,Q2,June 2008,-374450604,46837566,421288170
Nonmetallic Mineral Products,July,2008,Q3,July 2008,-396917552,47355840,444273392
Nonmetallic Mineral Products,August,2008,Q3,August 2008,-451377330,50856126,502233456
Nonmetallic Mineral Products,September,2008,Q3,September 2008,-474041356,38276364,512317720
Nonmetallic Mineral Products,October,2008,Q4,October 2008,-430384620,39439922,469824542
Nonmetallic Mineral Products,November,2008,Q4,November 2008,-380736146,43917000,424653146
Nonmetallic Mineral Products,December,2008,Q4,December 2008,-370367180,30484019,400851199
Nonmetallic Mineral Products,January,2009,Q1,January 2009,-376000819,27791070,403791889
Nonmetallic Mineral Products,February,2009,Q1,February 2009,-245104998,28863308,273968306
Nonmetallic Mineral Products,March,2009,Q1,March 2009,-218349087,36287828,254636915
Nonmetallic Mineral Products,April,2009,Q2,April 2009,-261962872,36031916,297994788
Nonmetallic Mineral Products,May,2009,Q2,May 2009,-256090236,47937098,304027334
Nonmetallic Mineral Products,June,2009,Q2,June 2009,-240207558,46210266,286417824
Nonmetallic Mineral Products,July,2009,Q3,July 2009,-287312916,45967442,333280358
Nonmetallic Mineral Products,August,2009,Q3,August 2009,-289158429,45278510,334436939
Nonmetallic Mineral Products,September,2009,Q3,September 2009,-322070195,42775966,364846161
Nonmetallic Mineral Products,October,2009,Q4,October 2009,-318950141,53758279,372708420
Nonmetallic Mineral Products,November,2009,Q4,November 2009,-293864494,49905172,343769666
Nonmetallic Mineral Products,December,2009,Q4,December 2009,-279774503,55996740,335771243
Nonmetallic Mineral Products,January,2010,Q1,January 2010,-317484514,47960032,365444546
Nonmetallic Mineral Products,February,2010,Q1,February 2010,-267013725,46471630,313485355
Nonmetallic Mineral Products,March,2010,Q1,March 2010,-293859058,47835024,341694082
Nonmetallic Mineral Products,April,2010,Q2,April 2010,-280469522,47726200,328195722
Nonmetallic Mineral Products,May,2010,Q2,May 2010,-341932873,51240836,393173709
Nonmetallic Mineral Products,June,2010,Q2,June 2010,-422399644,40075004,462474648
Nonmetallic Mineral Products,July,2010,Q3,July 2010,-433262282,47849643,481111925
Nonmetallic Mineral Products,August,2010,Q3,August 2010,-472438611,46582168,519020779
Nonmetallic Mineral Products,September,2010,Q3,September 2010,-449756099,50430721,500186820
Nonmetallic Mineral Products,October,2010,Q4,October 2010,-474704871,50637134,525342005
Nonmetallic Mineral Products,November,2010,Q4,November 2010,-401535957,50809759,452345716
Nonmetallic Mineral Products,December,2010,Q4,December 2010,-415434857,49655632,465090489
Nonmetallic Mineral Products,January,2011,Q1,January 2011,-421857917,49185863,471043780
Nonmetallic Mineral Products,February,2011,Q1,February 2011,-383020536,53148985,436169521
Nonmetallic Mineral Products,March,2011,Q1,March 2011,-291584769,63266716,354851485
Nonmetallic Mineral Products,April,2011,Q2,April 2011,-393568190,57810637,451378827
Nonmetallic Mineral Products,May,2011,Q2,May 2011,-437591787,53464534,491056321
Nonmetallic Mineral Products,June,2011,Q2,June 2011,-468681075,54978566,523659641
Nonmetallic Mineral Products,July,2011,Q3,July 2011,-472527795,51063830,523591625
Nonmetallic Mineral Products,August,2011,Q3,August 2011,-553975933,49687480,603663413
Nonmetallic Mineral Products,September,2011,Q3,September 2011,-518614607,43322169,561936776
Nonmetallic Mineral Products,October,2011,Q4,October 2011,-482295606,54328871,536624477
Nonmetallic Mineral Products,November,2011,Q4,November 2011,-432053157,41926467,473979624
Nonmetallic Mineral Products,December,2011,Q4,December 2011,-441279136,45392913,486672049
Nonmetallic Mineral Products,January,2012,Q1,January 2012,-547376998,41187944,588564942
Nonmetallic Mineral Products,February,2012,Q1,February 2012,-380098087,40767817,420865904
Nonmetallic Mineral Products,March,2012,Q1,March 2012,-350378782,44596006,394974788
Nonmetallic Mineral Products,April,2012,Q2,April 2012,-418914663,43321890,462236553
Nonmetallic Mineral Products,May,2012,Q2,May 2012,-456838137,48655479,505493616
Nonmetallic Mineral Products,June,2012,Q2,June 2012,-457590045,48271763,505861808
Nonmetallic Mineral Products,July,2012,Q3,July 2012,-471828356,58881063,530709419
Nonmetallic Mineral Products,August,2012,Q3,August 2012,-489434361,59592217,549026578
Nonmetallic Mineral Products,September,2012,Q3,September 2012,-528252266,59730447,587982713
Nonmetallic Mineral Products,October,2012,Q4,October 2012,-470646692,54909070,525555762
Nonmetallic Mineral Products,November,2012,Q4,November 2012,-423708236,50881993,474590229
Nonmetallic Mineral Products,December,2012,Q4,December 2012,-386400149,54470904,440871053
Nonmetallic Mineral Products,January,2013,Q1,January 2013,-510917516,49869865,560787381
Nonmetallic Mineral Products,February,2013,Q1,February 2013,-446473192,52949752,499422944
Nonmetallic Mineral Products,March,2013,Q1,March 2013,-288066974,62136717,350203691
Nonmetallic Mineral Products,April,2013,Q2,April 2013,-366175778,56122711,422298489
Nonmetallic Mineral Products,May,2013,Q2,May 2013,-446986898,57738874,504725772
Nonmetallic Mineral Products,June,2013,Q2,June 2013,-463944885,57204332,521149217
Nonmetallic Mineral Products,July,2013,Q3,July 2013,-529044822,48287462,577332284
Nonmetallic Mineral Products,August,2013,Q3,August 2013,-525198129,54987869,580185998
Nonmetallic Mineral Products,September,2013,Q3,September 2013,-520482985,49774789,570257774
Nonmetallic Mineral Products,October,2013,Q4,October 2013,-487027439,57595921,544623360
Nonmetallic Mineral Products,November,2013,Q4,November 2013,-436586782,56707878,493294660
Nonmetallic Mineral Products,December,2013,Q4,December 2013,-465398213,44916123,510314336
Nonmetallic Mineral Products,January,2014,Q1,January 2014,-568952538,49780816,618733354
Nonmetallic Mineral Products,February,2014,Q1,February 2014,-442682920,51065003,493747923
Nonmetallic Mineral Products,March,2014,Q1,March 2014,-336636583,61294418,397931001
Nonmetallic Mineral Products,April,2014,Q2,April 2014,-415945554,57152975,473098529
Nonmetallic Mineral Products,May,2014,Q2,May 2014,-529866493,57824095,587690588
Nonmetallic Mineral Products,June,2014,Q2,June 2014,-536543129,52498318,589041447
Nonmetallic Mineral Products,July,2014,Q3,July 2014,-540072385,63552964,603625349
Nonmetallic Mineral Products,August,2014,Q3,August 2014,-548084042,64815973,612900015
Nonmetallic Mineral Products,September,2014,Q3,September 2014,-608905629,68355089,677260718
Nonmetallic Mineral Products,October,2014,Q4,October 2014,-577720997,66940601,644661598
Nonmetallic Mineral Products,November,2014,Q4,November 2014,-494051218,56844168,550895386
Nonmetallic Mineral Products,December,2014,Q4,December 2014,-496035088,57186505,553221593
Nonmetallic Mineral Products,January,2015,Q1,January 2015,-547704195,51565992,599270187
Nonmetallic Mineral Products,February,2015,Q1,February 2015,-443390235,49136696,492526931
Nonmetallic Mineral Products,March,2015,Q1,March 2015,-569642519,61697022,631339541
Nonmetallic Mineral Products,April,2015,Q2,April 2015,-439211700,60201297,499412997
Nonmetallic Mineral Products,May,2015,Q2,May 2015,-522685761,69491717,592177478
Nonmetallic Mineral Products,June,2015,Q2,June 2015,-576049454,58598212,634647666
Nonmetallic Mineral Products,July,2015,Q3,July 2015,-588290074,57093559,645383633
Nonmetallic Mineral Products,August,2015,Q3,August 2015,-639984408,49671543,689655951
Nonmetallic Mineral Products,September,2015,Q3,September 2015,-623278034,49642362,672920396
Nonmetallic Mineral Products,October,2015,Q4,October 2015,-552538083,55731800,608269883
Nonmetallic Mineral Products,November,2015,Q4,November 2015,-514084321,62012286,576096607
Nonmetallic Mineral Products,December,2015,Q4,December 2015,-552843487,61170305,614013792
Nonmetallic Mineral Products,January,2016,Q1,January 2016,-570864421,60840968,631705389
Nonmetallic Mineral Products,February,2016,Q1,February 2016,-569493806,53672189,623165995
Nonmetallic Mineral Products,March,2016,Q1,March 2016,-377775402,57170348,434945750
Nonmetallic Mineral Products,April,2016,Q2,April 2016,-397529071,66517107,464046178
Nonmetallic Mineral Products,May,2016,Q2,May 2016,-528508663,61021886,589530549
Nonmetallic Mineral Products,June,2016,Q2,June 2016,-577590824,63133168,640723992
Nonmetallic Mineral Products,July,2016,Q3,July 2016,-576112078,61764868,637876946
Nonmetallic Mineral Products,August,2016,Q3,August 2016,-626902496,57979480,684881976
Nonmetallic Mineral Products,September,2016,Q3,September 2016,-557154625,62192920,619347545
Nonmetallic Mineral Products,October,2016,Q4,October 2016,-562488708,67751369,630240077
Nonmetallic Mineral Products,November,2016,Q4,November 2016,-544285178,65182924,609468102
Nonmetallic Mineral Products,December,2016,Q4,December 2016,-567784337,68742293,636526630
Nonmetallic Mineral Products,January,2017,Q1,January 2017,-594271658,62196586,656468244
Nonmetallic Mineral Products,February,2017,Q1,February 2017,-530762874,65038342,595801216
Nonmetallic Mineral Products,March,2017,Q1,March 2017,-392574237,82809429,475383666
Nonmetallic Mineral Products,April,2017,Q2,April 2017,-465011262,78744074,543755336
Nonmetallic Mineral Products,May,2017,Q2,May 2017,-600494841,71267388,671762229
Nonmetallic Mineral Products,June,2017,Q2,June 2017,-634365762,69458360,703824122
Nonmetallic Mineral Products,July,2017,Q3,July 2017,-638642267,68391418,707033685
Nonmetallic Mineral Products,August,2017,Q3,August 2017,-653187778,74755185,727942963
Nonmetallic Mineral Products,September,2017,Q3,September 2017,-623377007,77673978,701050985
Nonmetallic Mineral Products,October,2017,Q4,October 2017,-649915124,87924569,737839693
Nonmetallic Mineral Products,November,2017,Q4,November 2017,-580521375,85622218,666143593
Nonmetallic Mineral Products,December,2017,Q4,December 2017,-608009874,96445548,704455422
Nonmetallic Mineral Products,January,2018,Q1,January 2018,-657835482,77590740,735426222
Nonmetallic Mineral Products,February,2018,Q1,February 2018,-620195060,70359598,690554658
Nonmetallic Mineral Products,March,2018,Q1,March 2018,-544401419,96575116,640976535
Nonmetallic Mineral Products,April,2018,Q2,April 2018,-468836972,74955679,543792651
Nonmetallic Mineral Products,May,2018,Q2,May 2018,-697744810,83994001,781738811
Nonmetallic Mineral Products,June,2018,Q2,June 2018,-736727368,86136342,822863710
Nonmetallic Mineral Products,July,2018,Q3,July 2018,-788762641,77139958,865902599
Nonmetallic Mineral Products,August,2018,Q3,August 2018,-783284116,80565265,863849381
Nonmetallic Mineral Products,September,2018,Q3,September 2018,-730944204,73275293,804219497
Nonmetallic Mineral Products,October,2018,Q4,October 2018,-741522005,78458561,819980566
Nonmetallic Mineral Products,November,2018,Q4,November 2018,-697441997,72432390,769874387
Nonmetallic Mineral Products,December,2018,Q4,December 2018,-756775741,74489564,831265305
Nonmetallic Mineral Products,January,2019,Q1,January 2019,-667225773,68314195,735539968
Nonmetallic Mineral Products,February,2019,Q1,February 2019,-512989740,58860011,571849751
Nonmetallic Mineral Products,March,2019,Q1,March 2019,-430731312,70631589,501362901
Nonmetallic Mineral Products,April,2019,Q2,April 2019,-434950162,64920464,499870626
Nonmetallic Mineral Products,May,2019,Q2,May 2019,-562248191,73301214,635549405
Nonmetallic Mineral Products,June,2019,Q2,June 2019,-575993556,76118408,652111964
Nonmetallic Mineral Products,July,2019,Q3,July 2019,-590906942,61196770,652103712
Nonmetallic Mineral Products,August,2019,Q3,August 2019,-594310809,71411736,665722545
Nonmetallic Mineral Products,September,2019,Q3,September 2019,-541692646,62008026,603700672
Nonmetallic Mineral Products,October,2019,Q4,October 2019,-472740518,72725612,545466130
Nonmetallic Mineral Products,November,2019,Q4,November 2019,-432333498,71388371,503721869
Nonmetallic Mineral Products,December,2019,Q4,December 2019,-433748406,69939328,503687734
Primary Metal Mfg,January,2002,Q1,January 2002,-41449935,12824578,54274513
Primary Metal Mfg,February,2002,Q1,February 2002,-42351822,17650994,60002816
Primary Metal Mfg,March,2002,Q1,March 2002,-47111847,22853735,69965582
Primary Metal Mfg,April,2002,Q2,April 2002,-41032616,20022709,61055325
Primary Metal Mfg,May,2002,Q2,May 2002,-40368531,15369903,55738434
Primary Metal Mfg,June,2002,Q2,June 2002,-32210253,30753195,62963448
Primary Metal Mfg,July,2002,Q3,July 2002,-41164416,29128001,70292417
Primary Metal Mfg,August,2002,Q3,August 2002,-55528057,20058947,75587004
Primary Metal Mfg,September,2002,Q3,September 2002,-97006163,16030417,113036580
Primary Metal Mfg,October,2002,Q4,October 2002,-49717997,19074825,68792822
Primary Metal Mfg,November,2002,Q4,November 2002,-52725707,21357528,74083235
Primary Metal Mfg,December,2002,Q4,December 2002,-63262116,26970560,90232676
Primary Metal Mfg,January,2003,Q1,January 2003,-51879863,24234266,76114129
Primary Metal Mfg,February,2003,Q1,February 2003,-44574513,31277988,75852501
Primary Metal Mfg,March,2003,Q1,March 2003,4664909,91533251,86868342
Primary Metal Mfg,April,2003,Q2,April 2003,75278503,160112101,84833598
Primary Metal Mfg,May,2003,Q2,May 2003,31270842,110406976,79136134
Primary Metal Mfg,June,2003,Q2,June 2003,-8046612,68361231,76407843
Primary Metal Mfg,July,2003,Q3,July 2003,-56187750,43325431,99513181
Primary Metal Mfg,August,2003,Q3,August 2003,-40765879,38282112,79047991
Primary Metal Mfg,September,2003,Q3,September 2003,-45702491,32972583,78675074
Primary Metal Mfg,October,2003,Q4,October 2003,-21634197,56248386,77882583
Primary Metal Mfg,November,2003,Q4,November 2003,-17419976,69908270,87328246
Primary Metal Mfg,December,2003,Q4,December 2003,-10775995,74331177,85107172
Primary Metal Mfg,January,2004,Q1,January 2004,-61243874,50088190,111332064
Primary Metal Mfg,February,2004,Q1,February 2004,1694946,91561850,89866904
Primary Metal Mfg,March,2004,Q1,March 2004,-15252814,71342436,86595250
Primary Metal Mfg,April,2004,Q2,April 2004,-110686623,66112795,176799418
Primary Metal Mfg,May,2004,Q2,May 2004,-169112999,47645866,216758865
Primary Metal Mfg,June,2004,Q2,June 2004,-376470305,48476549,424946854
Primary Metal Mfg,July,2004,Q3,July 2004,-305028851,56483585,361512436
Primary Metal Mfg,August,2004,Q3,August 2004,-223521593,71947237,295468830
Primary Metal Mfg,September,2004,Q3,September 2004,-300548325,67256877,367805202
Primary Metal Mfg,October,2004,Q4,October 2004,-206048985,69820734,275869719
Primary Metal Mfg,November,2004,Q4,November 2004,-201355314,72416605,273771919
Primary Metal Mfg,December,2004,Q4,December 2004,-265953965,92604735,358558700
Primary Metal Mfg,January,2005,Q1,January 2005,-277741714,68944293,346686007
Primary Metal Mfg,February,2005,Q1,February 2005,-293935508,112684540,406620048
Primary Metal Mfg,March,2005,Q1,March 2005,-145490459,138501865,283992324
Primary Metal Mfg,April,2005,Q2,April 2005,-224038081,146917958,370956039
Primary Metal Mfg,May,2005,Q2,May 2005,-267630403,154334154,421964557
Primary Metal Mfg,June,2005,Q2,June 2005,-186983413,138866840,325850253
Primary Metal Mfg,July,2005,Q3,July 2005,-194451910,150157319,344609229
Primary Metal Mfg,August,2005,Q3,August 2005,-204243410,131699950,335943360
Primary Metal Mfg,September,2005,Q3,September 2005,-146922343,147274930,294197273
Primary Metal Mfg,October,2005,Q4,October 2005,-110637803,156802023,267439826
Primary Metal Mfg,November,2005,Q4,November 2005,-125557146,148780104,274337250
Primary Metal Mfg,December,2005,Q4,December 2005,-176837583,153044914,329882497
Primary Metal Mfg,January,2006,Q1,January 2006,-264433819,112790474,377224293
Primary Metal Mfg,February,2006,Q1,February 2006,-145098854,186897912,331996766
Primary Metal Mfg,March,2006,Q1,March 2006,-202828430,205635228,408463658
Primary Metal Mfg,April,2006,Q2,April 2006,-313968828,167978301,481947129
Primary Metal Mfg,May,2006,Q2,May 2006,-249742266,218702202,468444468
Primary Metal Mfg,June,2006,Q2,June 2006,-307646145,212573295,520219440
Primary Metal Mfg,July,2006,Q3,July 2006,-468588670,199960061,668548731
Primary Metal Mfg,August,2006,Q3,August 2006,-433172540,250257754,683430294
Primary Metal Mfg,September,2006,Q3,September 2006,-456746485,236723065,693469550
Primary Metal Mfg,October,2006,Q4,October 2006,-574415359,157472818,731888177
Primary Metal Mfg,November,2006,Q4,November 2006,-476268154,163051318,639319472
Primary Metal Mfg,December,2006,Q4,December 2006,-482446229,140933631,623379860
Primary Metal Mfg,January,2007,Q1,January 2007,-520412581,143921631,664334212
Primary Metal Mfg,February,2007,Q1,February 2007,-358793932,138408051,497201983
Primary Metal Mfg,March,2007,Q1,March 2007,-290770984,224407517,515178501
Primary Metal Mfg,April,2007,Q2,April 2007,-311697812,184837275,496535087
Primary Metal Mfg,May,2007,Q2,May 2007,-562870667,183856257,746726924
Primary Metal Mfg,June,2007,Q2,June 2007,-527369275,197820730,725190005
Primary Metal Mfg,July,2007,Q3,July 2007,-584894949,174401434,759296383
Primary Metal Mfg,August,2007,Q3,August 2007,-402406082,188798005,591204087
Primary Metal Mfg,September,2007,Q3,September 2007,-412457050,199086039,611543089
Primary Metal Mfg,October,2007,Q4,October 2007,-291128415,238092587,529221002
Primary Metal Mfg,November,2007,Q4,November 2007,-359763155,201423069,561186224
Primary Metal Mfg,December,2007,Q4,December 2007,-248578295,214324068,462902363
Primary Metal Mfg,January,2008,Q1,January 2008,-471436170,181777503,653213673
Primary Metal Mfg,February,2008,Q1,February 2008,-314396417,229485699,543882116
Primary Metal Mfg,March,2008,Q1,March 2008,-269005848,306108232,575114080
Primary Metal Mfg,April,2008,Q2,April 2008,-394053486,259333058,653386544
Primary Metal Mfg,May,2008,Q2,May 2008,-476673097,276881216,753554313
Primary Metal Mfg,June,2008,Q2,June 2008,-627537519,274980162,902517681
Primary Metal Mfg,July,2008,Q3,July 2008,-700379402,272105899,972485301
Primary Metal Mfg,August,2008,Q3,August 2008,-879490215,255972375,1135462590
Primary Metal Mfg,September,2008,Q3,September 2008,-894910944,260189718,1155100662
Primary Metal Mfg,October,2008,Q4,October 2008,-1024004744,295489049,1319493793
Primary Metal Mfg,November,2008,Q4,November 2008,-895923510,203375017,1099298527
Primary Metal Mfg,December,2008,Q4,December 2008,-652196123,219121040,871317163
Primary Metal Mfg,January,2009,Q1,January 2009,-638915500,120870260,759785760
Primary Metal Mfg,February,2009,Q1,February 2009,-351924334,154058963,505983297
Primary Metal Mfg,March,2009,Q1,March 2009,-184809422,207087945,391897367
Primary Metal Mfg,April,2009,Q2,April 2009,-81198496,180018601,261217097
Primary Metal Mfg,May,2009,Q2,May 2009,-118160664,223064285,341224949
Primary Metal Mfg,June,2009,Q2,June 2009,50577253,239876473,189299220
Primary Metal Mfg,July,2009,Q3,July 2009,32398780,227069648,194670868
Primary Metal Mfg,August,2009,Q3,August 2009,37827262,238738698,200911436
Primary Metal Mfg,September,2009,Q3,September 2009,-13585577,223253981,236839558
Primary Metal Mfg,October,2009,Q4,October 2009,-53325581,208463739,261789320
Primary Metal Mfg,November,2009,Q4,November 2009,-78895814,184313917,263209731
Primary Metal Mfg,December,2009,Q4,December 2009,69158292,305671695,236513403
Primary Metal Mfg,January,2010,Q1,January 2010,-49454883,227822566,277277449
Primary Metal Mfg,February,2010,Q1,February 2010,35776052,238505569,202729517
Primary Metal Mfg,March,2010,Q1,March 2010,6888848,280227266,273338418
Primary Metal Mfg,April,2010,Q2,April 2010,-46022923,282680354,328703277
Primary Metal Mfg,May,2010,Q2,May 2010,-73965873,246214344,320180217
Primary Metal Mfg,June,2010,Q2,June 2010,-128283348,261390257,389673605
Primary Metal Mfg,July,2010,Q3,July 2010,-138809247,232681234,371490481
Primary Metal Mfg,August,2010,Q3,August 2010,-125473546,223275198,348748744
Primary Metal Mfg,September,2010,Q3,September 2010,-90924759,226365491,317290250
Primary Metal Mfg,October,2010,Q4,October 2010,26335677,267712899,241377222
Primary Metal Mfg,November,2010,Q4,November 2010,24329073,261857492,237528419
Primary Metal Mfg,December,2010,Q4,December 2010,82868433,346218823,263350390
Primary Metal Mfg,January,2011,Q1,January 2011,-39069029,228810820,267879849
Primary Metal Mfg,February,2011,Q1,February 2011,29038700,291510296,262471596
Primary Metal Mfg,March,2011,Q1,March 2011,22852056,282539429,259687373
Primary Metal Mfg,April,2011,Q2,April 2011,-87615239,224898687,312513926
Primary Metal Mfg,May,2011,Q2,May 2011,-159151723,215457356,374609079
Primary Metal Mfg,June,2011,Q2,June 2011,-273899085,234714085,508613170
Primary Metal Mfg,July,2011,Q3,July 2011,-185993090,245344853,431337943
Primary Metal Mfg,August,2011,Q3,August 2011,-227251021,210071503,437322524
Primary Metal Mfg,September,2011,Q3,September 2011,-20566173,379302260,399868433
Primary Metal Mfg,October,2011,Q4,October 2011,-147521251,202966862,350488113
Primary Metal Mfg,November,2011,Q4,November 2011,-156454723,152349860,308804583
Primary Metal Mfg,December,2011,Q4,December 2011,-146111873,182213063,328324936
Primary Metal Mfg,January,2012,Q1,January 2012,-132285851,236025396,368311247
Primary Metal Mfg,February,2012,Q1,February 2012,-57531621,249471561,307003182
Primary Metal Mfg,March,2012,Q1,March 2012,-6393399,318241017,324634416
Primary Metal Mfg,April,2012,Q2,April 2012,57619984,442532657,384912673
Primary Metal Mfg,May,2012,Q2,May 2012,30729576,473641589,442912013
Primary Metal Mfg,June,2012,Q2,June 2012,-228837222,249435850,478273072
Primary Metal Mfg,July,2012,Q3,July 2012,-182951562,244779389,427730951
Primary Metal Mfg,August,2012,Q3,August 2012,-251896759,173430375,425327134
Primary Metal Mfg,September,2012,Q3,September 2012,-191484714,179660218,371144932
Primary Metal Mfg,October,2012,Q4,October 2012,-178821798,190648754,369470552
Primary Metal Mfg,November,2012,Q4,November 2012,-160482121,169487353,329969474
Primary Metal Mfg,December,2012,Q4,December 2012,-159969830,193112268,353082098
Primary Metal Mfg,January,2013,Q1,January 2013,39405944,450037781,410631837
Primary Metal Mfg,February,2013,Q1,February 2013,-200453520,138623605,339077125
Primary Metal Mfg,March,2013,Q1,March 2013,-152434796,169755467,322190263
Primary Metal Mfg,April,2013,Q2,April 2013,31721895,401525795,369803900
Primary Metal Mfg,May,2013,Q2,May 2013,-193742898,231341124,425084022
Primary Metal Mfg,June,2013,Q2,June 2013,-258602866,138597690,397200556
Primary Metal Mfg,July,2013,Q3,July 2013,-264612375,167825360,432437735
Primary Metal Mfg,August,2013,Q3,August 2013,-86930496,278716063,365646559
Primary Metal Mfg,September,2013,Q3,September 2013,-181520149,238668667,420188816
Primary Metal Mfg,October,2013,Q4,October 2013,-173760720,241372821,415133541
Primary Metal Mfg,November,2013,Q4,November 2013,-85441657,260050908,345492565
Primary Metal Mfg,December,2013,Q4,December 2013,-98008206,275344643,373352849
Primary Metal Mfg,January,2014,Q1,January 2014,-242941781,192303065,435244846
Primary Metal Mfg,February,2014,Q1,February 2014,-159106060,206410364,365516424
Primary Metal Mfg,March,2014,Q1,March 2014,-187492946,213117497,400610443
Primary Metal Mfg,April,2014,Q2,April 2014,-356311894,210756207,567068101
Primary Metal Mfg,May,2014,Q2,May 2014,-333506574,224612706,558119280
Primary Metal Mfg,June,2014,Q2,June 2014,-354515814,204520672,559036486
Primary Metal Mfg,July,2014,Q3,July 2014,-311300814,230041511,541342325
Primary Metal Mfg,August,2014,Q3,August 2014,-319503938,195262646,514766584
Primary Metal Mfg,September,2014,Q3,September 2014,-228654595,363818086,592472681
Primary Metal Mfg,October,2014,Q4,October 2014,-90307193,556996339,647303532
Primary Metal Mfg,November,2014,Q4,November 2014,-250544029,272035283,522579312
Primary Metal Mfg,December,2014,Q4,December 2014,-252527247,253654987,506182234
Primary Metal Mfg,January,2015,Q1,January 2015,-399169036,144042419,543211455
Primary Metal Mfg,February,2015,Q1,February 2015,-407434394,134779027,542213421
Primary Metal Mfg,March,2015,Q1,March 2015,-402940672,194951169,597891841
Primary Metal Mfg,April,2015,Q2,April 2015,-418745945,174606879,593352824
Primary Metal Mfg,May,2015,Q2,May 2015,-436671675,164117780,600789455
Primary Metal Mfg,June,2015,Q2,June 2015,-350769994,135625454,486395448
Primary Metal Mfg,July,2015,Q3,July 2015,-369508115,138936635,508444750
Primary Metal Mfg,August,2015,Q3,August 2015,-283281134,136304412,419585546
Primary Metal Mfg,September,2015,Q3,September 2015,-246586365,125298756,371885121
Primary Metal Mfg,October,2015,Q4,October 2015,-158909534,139531782,298441316
Primary Metal Mfg,November,2015,Q4,November 2015,-184783620,105699329,290482949
Primary Metal Mfg,December,2015,Q4,December 2015,-133078721,207363957,340442678
Primary Metal Mfg,January,2016,Q1,January 2016,-189217823,144678225,333896048
Primary Metal Mfg,February,2016,Q1,February 2016,-151488961,156357478,307846439
Primary Metal Mfg,March,2016,Q1,March 2016,-89447154,184789738,274236892
Primary Metal Mfg,April,2016,Q2,April 2016,-142931843,159408791,302340634
Primary Metal Mfg,May,2016,Q2,May 2016,-225275780,126964603,352240383
Primary Metal Mfg,June,2016,Q2,June 2016,-218073189,116947073,335020262
Primary Metal Mfg,July,2016,Q3,July 2016,-190898114,134013771,324911885
Primary Metal Mfg,August,2016,Q3,August 2016,-209783451,112512765,322296216
Primary Metal Mfg,September,2016,Q3,September 2016,-206774062,114940624,321714686
Primary Metal Mfg,October,2016,Q4,October 2016,-203114030,144739642,347853672
Primary Metal Mfg,November,2016,Q4,November 2016,-87713637,226590048,314303685
Primary Metal Mfg,December,2016,Q4,December 2016,-168332045,166124118,334456163
Primary Metal Mfg,January,2017,Q1,January 2017,-136967392,200232174,337199566
Primary Metal Mfg,February,2017,Q1,February 2017,-206424257,96883156,303307413
Primary Metal Mfg,March,2017,Q1,March 2017,-136998091,188286508,325284599
Primary Metal Mfg,April,2017,Q2,April 2017,-208918168,156042370,364960538
Primary Metal Mfg,May,2017,Q2,May 2017,-213096941,246459757,459556698
Primary Metal Mfg,June,2017,Q2,June 2017,-169980508,258300493,428281001
Primary Metal Mfg,July,2017,Q3,July 2017,-251045986,197678745,448724731
Primary Metal Mfg,August,2017,Q3,August 2017,-164260561,230716772,394977333
Primary Metal Mfg,September,2017,Q3,September 2017,-153329209,180710611,334039820
Primary Metal Mfg,October,2017,Q4,October 2017,-151615451,207080386,358695837
Primary Metal Mfg,November,2017,Q4,November 2017,-187270482,137699146,324969628
Primary Metal Mfg,December,2017,Q4,December 2017,-202457826,163124203,365582029
Primary Metal Mfg,January,2018,Q1,January 2018,-323070240,185688904,508759144
Primary Metal Mfg,February,2018,Q1,February 2018,-140501354,190658008,331159362
Primary Metal Mfg,March,2018,Q1,March 2018,-13853839,384364205,398218044
Primary Metal Mfg,April,2018,Q2,April 2018,698761,311571660,310872899
Primary Metal Mfg,May,2018,Q2,May 2018,-116149783,234636467,350786250
Primary Metal Mfg,June,2018,Q2,June 2018,141607310,452990157,311382847
Primary Metal Mfg,July,2018,Q3,July 2018,-161294898,153730696,315025594
Primary Metal Mfg,August,2018,Q3,August 2018,-123576688,195150692,318727380
Primary Metal Mfg,September,2018,Q3,September 2018,-101831450,184570374,286401824
Primary Metal Mfg,October,2018,Q4,October 2018,13855941,314168372,300312431
Primary Metal Mfg,November,2018,Q4,November 2018,41606587,339247255,297640668
Primary Metal Mfg,December,2018,Q4,December 2018,-171022401,144099991,315122392
Primary Metal Mfg,January,2019,Q1,January 2019,-219508616,119566034,339074650
Primary Metal Mfg,February,2019,Q1,February 2019,-134487651,133023144,267510795
Primary Metal Mfg,March,2019,Q1,March 2019,-93875404,168623928,262499332
Primary Metal Mfg,April,2019,Q2,April 2019,-107995637,149894045,257889682
Primary Metal Mfg,May,2019,Q2,May 2019,-78795123,194129625,272924748
Primary Metal Mfg,June,2019,Q2,June 2019,-97134544,171683552,268818096
Primary Metal Mfg,July,2019,Q3,July 2019,-93338980,138208501,231547481
Primary Metal Mfg,August,2019,Q3,August 2019,-82046074,168481809,250527883
Primary Metal Mfg,September,2019,Q3,September 2019,-60218670,153197671,213416341
Primary Metal Mfg,October,2019,Q4,October 2019,2166226,203599726,201433500
Primary Metal Mfg,November,2019,Q4,November 2019,51769190,212689250,160920060
Primary Metal Mfg,December,2019,Q4,December 2019,31591673,206546869,174955196
"Fabricated Metal Products, Nesoi",January,2002,Q1,January 2002,-317898307,22286828,340185135
"Fabricated Metal Products, Nesoi",February,2002,Q1,February 2002,-305778272,27516570,333294842
"Fabricated Metal Products, Nesoi",March,2002,Q1,March 2002,-256888487,29228135,286116622
"Fabricated Metal Products, Nesoi",April,2002,Q2,April 2002,-367556836,31263434,398820270
"Fabricated Metal Products, Nesoi",May,2002,Q2,May 2002,-412011916,26072980,438084896
"Fabricated Metal Products, Nesoi",June,2002,Q2,June 2002,-391663507,30133996,421797503
"Fabricated Metal Products, Nesoi",July,2002,Q3,July 2002,-401488681,31807400,433296081
"Fabricated Metal Products, Nesoi",August,2002,Q3,August 2002,-422095457,36005190,458100647
"Fabricated Metal Products, Nesoi",September,2002,Q3,September 2002,-420638145,32060215,452698360
"Fabricated Metal Products, Nesoi",October,2002,Q4,October 2002,-377372864,31597025,408969889
"Fabricated Metal Products, Nesoi",November,2002,Q4,November 2002,-394790553,42547757,437338310
"Fabricated Metal Products, Nesoi",December,2002,Q4,December 2002,-450029909,34690814,484720723
"Fabricated Metal Products, Nesoi",January,2003,Q1,January 2003,-449554029,47563539,497117568
"Fabricated Metal Products, Nesoi",February,2003,Q1,February 2003,-401579372,32570023,434149395
"Fabricated Metal Products, Nesoi",March,2003,Q1,March 2003,-328218204,66135230,394353434
"Fabricated Metal Products, Nesoi",April,2003,Q2,April 2003,-447369305,53922188,501291493
"Fabricated Metal Products, Nesoi",May,2003,Q2,May 2003,-447964311,32893678,480857989
"Fabricated Metal Products, Nesoi",June,2003,Q2,June 2003,-427973411,33984910,461958321
"Fabricated Metal Products, Nesoi",July,2003,Q3,July 2003,-457896969,34960903,492857872
"Fabricated Metal Products, Nesoi",August,2003,Q3,August 2003,-453742117,33922879,487664996
"Fabricated Metal Products, Nesoi",September,2003,Q3,September 2003,-469712362,39310439,509022801
"Fabricated Metal Products, Nesoi",October,2003,Q4,October 2003,-549581670,37203778,586785448
"Fabricated Metal Products, Nesoi",November,2003,Q4,November 2003,-451480005,41395076,492875081
"Fabricated Metal Products, Nesoi",December,2003,Q4,December 2003,-444697043,55489440,500186483
"Fabricated Metal Products, Nesoi",January,2004,Q1,January 2004,-514349635,39165979,553515614
"Fabricated Metal Products, Nesoi",February,2004,Q1,February 2004,-380602877,51927658,432530535
"Fabricated Metal Products, Nesoi",March,2004,Q1,March 2004,-426885317,65179917,492065234
"Fabricated Metal Products, Nesoi",April,2004,Q2,April 2004,-551253592,62321198,613574790
"Fabricated Metal Products, Nesoi",May,2004,Q2,May 2004,-555048855,60557549,615606404
"Fabricated Metal Products, Nesoi",June,2004,Q2,June 2004,-625094589,55429829,680524418
"Fabricated Metal Products, Nesoi",July,2004,Q3,July 2004,-621730390,52836029,674566419
"Fabricated Metal Products, Nesoi",August,2004,Q3,August 2004,-636352929,59558376,695911305
"Fabricated Metal Products, Nesoi",September,2004,Q3,September 2004,-643692295,50636481,694328776
"Fabricated Metal Products, Nesoi",October,2004,Q4,October 2004,-664467351,56723161,721190512
"Fabricated Metal Products, Nesoi",November,2004,Q4,November 2004,-652603366,53107493,705710859
"Fabricated Metal Products, Nesoi",December,2004,Q4,December 2004,-635484617,57366887,692851504
"Fabricated Metal Products, Nesoi",January,2005,Q1,January 2005,-668697096,55751839,724448935
"Fabricated Metal Products, Nesoi",February,2005,Q1,February 2005,-626731076,50208031,676939107
"Fabricated Metal Products, Nesoi",March,2005,Q1,March 2005,-529597126,66271762,595868888
"Fabricated Metal Products, Nesoi",April,2005,Q2,April 2005,-662660651,56125231,718785882
"Fabricated Metal Products, Nesoi",May,2005,Q2,May 2005,-720793733,68162368,788956101
"Fabricated Metal Products, Nesoi",June,2005,Q2,June 2005,-746432365,71240372,817672737
"Fabricated Metal Products, Nesoi",July,2005,Q3,July 2005,-741679620,80693056,822372676
"Fabricated Metal Products, Nesoi",August,2005,Q3,August 2005,-815009654,77635575,892645229
"Fabricated Metal Products, Nesoi",September,2005,Q3,September 2005,-799583319,72227124,871810443
"Fabricated Metal Products, Nesoi",October,2005,Q4,October 2005,-831303624,83650437,914954061
"Fabricated Metal Products, Nesoi",November,2005,Q4,November 2005,-773689096,75139056,848828152
"Fabricated Metal Products, Nesoi",December,2005,Q4,December 2005,-712086422,98120041,810206463
"Fabricated Metal Products, Nesoi",January,2006,Q1,January 2006,-828356949,65533252,893890201
"Fabricated Metal Products, Nesoi",February,2006,Q1,February 2006,-697261913,65350390,762612303
"Fabricated Metal Products, Nesoi",March,2006,Q1,March 2006,-679413654,83848668,763262322
"Fabricated Metal Products, Nesoi",April,2006,Q2,April 2006,-856365428,77929864,934295292
"Fabricated Metal Products, Nesoi",May,2006,Q2,May 2006,-917521759,89015353,1006537112
"Fabricated Metal Products, Nesoi",June,2006,Q2,June 2006,-971830839,84177868,1056008707
"Fabricated Metal Products, Nesoi",July,2006,Q3,July 2006,-1007345061,81760343,1089105404
"Fabricated Metal Products, Nesoi",August,2006,Q3,August 2006,-1026461214,86728928,1113190142
"Fabricated Metal Products, Nesoi",September,2006,Q3,September 2006,-987647024,81724032,1069371056
"Fabricated Metal Products, Nesoi",October,2006,Q4,October 2006,-1047670514,92908328,1140578842
"Fabricated Metal Products, Nesoi",November,2006,Q4,November 2006,-977179974,80921495,1058101469
"Fabricated Metal Products, Nesoi",December,2006,Q4,December 2006,-864177851,93583435,957761286
"Fabricated Metal Products, Nesoi",January,2007,Q1,January 2007,-1029438728,75124600,1104563328
"Fabricated Metal Products, Nesoi",February,2007,Q1,February 2007,-882096770,72432409,954529179
"Fabricated Metal Products, Nesoi",March,2007,Q1,March 2007,-798720229,92909550,891629779
"Fabricated Metal Products, Nesoi",April,2007,Q2,April 2007,-876883563,94344505,971228068
"Fabricated Metal Products, Nesoi",May,2007,Q2,May 2007,-1064233274,99051101,1163284375
"Fabricated Metal Products, Nesoi",June,2007,Q2,June 2007,-1061849854,97488609,1159338463
"Fabricated Metal Products, Nesoi",July,2007,Q3,July 2007,-1196696344,88581113,1285277457
"Fabricated Metal Products, Nesoi",August,2007,Q3,August 2007,-1092480749,103138274,1195619023
"Fabricated Metal Products, Nesoi",September,2007,Q3,September 2007,-1086869868,82325584,1169195452
"Fabricated Metal Products, Nesoi",October,2007,Q4,October 2007,-1172693942,93998638,1266692580
"Fabricated Metal Products, Nesoi",November,2007,Q4,November 2007,-1076327629,94426763,1170754392
"Fabricated Metal Products, Nesoi",December,2007,Q4,December 2007,-966941437,95922657,1062864094
"Fabricated Metal Products, Nesoi",January,2008,Q1,January 2008,-1104957148,90910297,1195867445
"Fabricated Metal Products, Nesoi",February,2008,Q1,February 2008,-1022002143,109386841,1131388984
"Fabricated Metal Products, Nesoi",March,2008,Q1,March 2008,-754797156,112581252,867378408
"Fabricated Metal Products, Nesoi",April,2008,Q2,April 2008,-1005440491,114300730,1119741221
"Fabricated Metal Products, Nesoi",May,2008,Q2,May 2008,-1159166040,124048463,1283214503
"Fabricated Metal Products, Nesoi",June,2008,Q2,June 2008,-1064207077,124173273,1188380350
"Fabricated Metal Products, Nesoi",July,2008,Q3,July 2008,-1275761408,107198854,1382960262
"Fabricated Metal Products, Nesoi",August,2008,Q3,August 2008,-1287386815,117374467,1404761282
"Fabricated Metal Products, Nesoi",September,2008,Q3,September 2008,-1307776013,103370056,1411146069
"Fabricated Metal Products, Nesoi",October,2008,Q4,October 2008,-1331407983,120745463,1452153446
"Fabricated Metal Products, Nesoi",November,2008,Q4,November 2008,-1148162860,122169617,1270332477
"Fabricated Metal Products, Nesoi",December,2008,Q4,December 2008,-1079300628,110682131,1189982759
"Fabricated Metal Products, Nesoi",January,2009,Q1,January 2009,-1108981770,86964184,1195945954
"Fabricated Metal Products, Nesoi",February,2009,Q1,February 2009,-761728055,97798855,859526910
"Fabricated Metal Products, Nesoi",March,2009,Q1,March 2009,-705229192,109057747,814286939
"Fabricated Metal Products, Nesoi",April,2009,Q2,April 2009,-838424750,106427218,944851968
"Fabricated Metal Products, Nesoi",May,2009,Q2,May 2009,-826454616,108022349,934476965
"Fabricated Metal Products, Nesoi",June,2009,Q2,June 2009,-820908816,111841891,932750707
"Fabricated Metal Products, Nesoi",July,2009,Q3,July 2009,-829016332,122417900,951434232
"Fabricated Metal Products, Nesoi",August,2009,Q3,August 2009,-817459529,101355012,918814541
"Fabricated Metal Products, Nesoi",September,2009,Q3,September 2009,-874836875,105737948,980574823
"Fabricated Metal Products, Nesoi",October,2009,Q4,October 2009,-883040790,108525177,991565967
"Fabricated Metal Products, Nesoi",November,2009,Q4,November 2009,-817220847,111592269,928813116
"Fabricated Metal Products, Nesoi",December,2009,Q4,December 2009,-871020339,104059491,975079830
"Fabricated Metal Products, Nesoi",January,2010,Q1,January 2010,-928059095,102733685,1030792780
"Fabricated Metal Products, Nesoi",February,2010,Q1,February 2010,-824124560,102923981,927048541
"Fabricated Metal Products, Nesoi",March,2010,Q1,March 2010,-817266505,118392135,935658640
"Fabricated Metal Products, Nesoi",April,2010,Q2,April 2010,-866131345,126821679,992953024
"Fabricated Metal Products, Nesoi",May,2010,Q2,May 2010,-1050383089,134275955,1184659044
"Fabricated Metal Products, Nesoi",June,2010,Q2,June 2010,-1207073273,117050226,1324123499
"Fabricated Metal Products, Nesoi",July,2010,Q3,July 2010,-1235389728,131671869,1367061597
"Fabricated Metal Products, Nesoi",August,2010,Q3,August 2010,-1272561901,140266781,1412828682
"Fabricated Metal Products, Nesoi",September,2010,Q3,September 2010,-1168720192,128979870,1297700062
"Fabricated Metal Products, Nesoi",October,2010,Q4,October 2010,-1165630841,139663580,1305294421
"Fabricated Metal Products, Nesoi",November,2010,Q4,November 2010,-1026948430,131451600,1158400030
"Fabricated Metal Products, Nesoi",December,2010,Q4,December 2010,-1021070540,185302811,1206373351
"Fabricated Metal Products, Nesoi",January,2011,Q1,January 2011,-1180051794,126575461,1306627255
"Fabricated Metal Products, Nesoi",February,2011,Q1,February 2011,-1111346284,129438187,1240784471
"Fabricated Metal Products, Nesoi",March,2011,Q1,March 2011,-796940509,170737048,967677557
"Fabricated Metal Products, Nesoi",April,2011,Q2,April 2011,-1148430058,155419316,1303849374
"Fabricated Metal Products, Nesoi",May,2011,Q2,May 2011,-1261112803,178155764,1439268567
"Fabricated Metal Products, Nesoi",June,2011,Q2,June 2011,-1305149414,155255882,1460405296
"Fabricated Metal Products, Nesoi",July,2011,Q3,July 2011,-1260634171,172559768,1433193939
"Fabricated Metal Products, Nesoi",August,2011,Q3,August 2011,-1488874713,152859999,1641734712
"Fabricated Metal Products, Nesoi",September,2011,Q3,September 2011,-1405936918,137383888,1543320806
"Fabricated Metal Products, Nesoi",October,2011,Q4,October 2011,-1306980304,142321503,1449301807
"Fabricated Metal Products, Nesoi",November,2011,Q4,November 2011,-1278574379,159088152,1437662531
"Fabricated Metal Products, Nesoi",December,2011,Q4,December 2011,-1245579469,151205343,1396784812
"Fabricated Metal Products, Nesoi",January,2012,Q1,January 2012,-1435952286,130249170,1566201456
"Fabricated Metal Products, Nesoi",February,2012,Q1,February 2012,-1119427352,136253459,1255680811
"Fabricated Metal Products, Nesoi",March,2012,Q1,March 2012,-1063689420,169513418,1233202838
"Fabricated Metal Products, Nesoi",April,2012,Q2,April 2012,-1423714370,168080377,1591794747
"Fabricated Metal Products, Nesoi",May,2012,Q2,May 2012,-1579970575,155986465,1735957040
"Fabricated Metal Products, Nesoi",June,2012,Q2,June 2012,-1519714895,156294965,1676009860
"Fabricated Metal Products, Nesoi",July,2012,Q3,July 2012,-1567491231,154522188,1722013419
"Fabricated Metal Products, Nesoi",August,2012,Q3,August 2012,-1436791898,157588432,1594380330
"Fabricated Metal Products, Nesoi",September,2012,Q3,September 2012,-1399011807,153277486,1552289293
"Fabricated Metal Products, Nesoi",October,2012,Q4,October 2012,-1431893761,142594927,1574488688
"Fabricated Metal Products, Nesoi",November,2012,Q4,November 2012,-1219876499,167028078,1386904577
"Fabricated Metal Products, Nesoi",December,2012,Q4,December 2012,-1195532031,180193155,1375725186
"Fabricated Metal Products, Nesoi",January,2013,Q1,January 2013,-1474017461,145148592,1619166053
"Fabricated Metal Products, Nesoi",February,2013,Q1,February 2013,-1179389108,319429452,1498818560
"Fabricated Metal Products, Nesoi",March,2013,Q1,March 2013,-914125698,173248775,1087374473
"Fabricated Metal Products, Nesoi",April,2013,Q2,April 2013,-1287013287,161580537,1448593824
"Fabricated Metal Products, Nesoi",May,2013,Q2,May 2013,-1418901879,208150646,1627052525
"Fabricated Metal Products, Nesoi",June,2013,Q2,June 2013,-1396100808,191214609,1587315417
"Fabricated Metal Products, Nesoi",July,2013,Q3,July 2013,-1514242053,176274295,1690516348
"Fabricated Metal Products, Nesoi",August,2013,Q3,August 2013,-1501893428,184132907,1686026335
"Fabricated Metal Products, Nesoi",September,2013,Q3,September 2013,-1483462150,170131160,1653593310
"Fabricated Metal Products, Nesoi",October,2013,Q4,October 2013,-1463607053,189510587,1653117640
"Fabricated Metal Products, Nesoi",November,2013,Q4,November 2013,-1317617430,173370021,1490987451
"Fabricated Metal Products, Nesoi",December,2013,Q4,December 2013,-1370682829,165811822,1536494651
"Fabricated Metal Products, Nesoi",January,2014,Q1,January 2014,-1655579823,144597382,1800177205
"Fabricated Metal Products, Nesoi",February,2014,Q1,February 2014,-1299947388,162023649,1461971037
"Fabricated Metal Products, Nesoi",March,2014,Q1,March 2014,-1098265917,204022554,1302288471
"Fabricated Metal Products, Nesoi",April,2014,Q2,April 2014,-1368906491,222186810,1591093301
"Fabricated Metal Products, Nesoi",May,2014,Q2,May 2014,-1583472374,189700991,1773173365
"Fabricated Metal Products, Nesoi",June,2014,Q2,June 2014,-1614598350,171845582,1786443932
"Fabricated Metal Products, Nesoi",July,2014,Q3,July 2014,-1562382767,202590950,1764973717
"Fabricated Metal Products, Nesoi",August,2014,Q3,August 2014,-1544169623,205899602,1750069225
"Fabricated Metal Products, Nesoi",September,2014,Q3,September 2014,-1668828390,183204264,1852032654
"Fabricated Metal Products, Nesoi",October,2014,Q4,October 2014,-1656567962,203145844,1859713806
"Fabricated Metal Products, Nesoi",November,2014,Q4,November 2014,-1327914777,198323970,1526238747
"Fabricated Metal Products, Nesoi",December,2014,Q4,December 2014,-1520327558,186446661,1706774219
"Fabricated Metal Products, Nesoi",January,2015,Q1,January 2015,-1672642162,169744636,1842386798
"Fabricated Metal Products, Nesoi",February,2015,Q1,February 2015,-1228749480,227793695,1456543175
"Fabricated Metal Products, Nesoi",March,2015,Q1,March 2015,-1731985575,223931390,1955916965
"Fabricated Metal Products, Nesoi",April,2015,Q2,April 2015,-1454888908,210678235,1665567143
"Fabricated Metal Products, Nesoi",May,2015,Q2,May 2015,-1639889541,214606293,1854495834
"Fabricated Metal Products, Nesoi",June,2015,Q2,June 2015,-1698192138,167016429,1865208567
"Fabricated Metal Products, Nesoi",July,2015,Q3,July 2015,-1618481620,194029092,1812510712
"Fabricated Metal Products, Nesoi",August,2015,Q3,August 2015,-1691404739,188745169,1880149908
"Fabricated Metal Products, Nesoi",September,2015,Q3,September 2015,-1690787553,174372410,1865159963
"Fabricated Metal Products, Nesoi",October,2015,Q4,October 2015,-1549383166,190784260,1740167426
"Fabricated Metal Products, Nesoi",November,2015,Q4,November 2015,-1437211460,178385074,1615596534
"Fabricated Metal Products, Nesoi",December,2015,Q4,December 2015,-1489470321,183093816,1672564137
"Fabricated Metal Products, Nesoi",January,2016,Q1,January 2016,-1643135488,155969630,1799105118
"Fabricated Metal Products, Nesoi",February,2016,Q1,February 2016,-1466367362,334661229,1801028591
"Fabricated Metal Products, Nesoi",March,2016,Q1,March 2016,-1020179155,279639161,1299818316
"Fabricated Metal Products, Nesoi",April,2016,Q2,April 2016,-1400971005,195791824,1596762829
"Fabricated Metal Products, Nesoi",May,2016,Q2,May 2016,-1640372745,164498527,1804871272
"Fabricated Metal Products, Nesoi",June,2016,Q2,June 2016,-1590452364,201846454,1792298818
"Fabricated Metal Products, Nesoi",July,2016,Q3,July 2016,-1632881595,161235036,1794116631
"Fabricated Metal Products, Nesoi",August,2016,Q3,August 2016,-1812992703,155256843,1968249546
"Fabricated Metal Products, Nesoi",September,2016,Q3,September 2016,-1625751688,160864544,1786616232
"Fabricated Metal Products, Nesoi",October,2016,Q4,October 2016,-1629453548,188749935,1818203483
"Fabricated Metal Products, Nesoi",November,2016,Q4,November 2016,-1653942358,168234909,1822177267
"Fabricated Metal Products, Nesoi",December,2016,Q4,December 2016,-1579254818,192951158,1772205976
"Fabricated Metal Products, Nesoi",January,2017,Q1,January 2017,-1847287167,149409818,1996696985
"Fabricated Metal Products, Nesoi",February,2017,Q1,February 2017,-1409963506,334651902,1744615408
"Fabricated Metal Products, Nesoi",March,2017,Q1,March 2017,-1234481956,199261315,1433743271
"Fabricated Metal Products, Nesoi",April,2017,Q2,April 2017,-1601224912,188648445,1789873357
"Fabricated Metal Products, Nesoi",May,2017,Q2,May 2017,-1875859577,188941436,2064801013
"Fabricated Metal Products, Nesoi",June,2017,Q2,June 2017,-1790838948,177211199,1968050147
"Fabricated Metal Products, Nesoi",July,2017,Q3,July 2017,-1819935875,178629675,1998565550
"Fabricated Metal Products, Nesoi",August,2017,Q3,August 2017,-1830033266,196247738,2026281004
"Fabricated Metal Products, Nesoi",September,2017,Q3,September 2017,-1708058246,159528636,1867586882
"Fabricated Metal Products, Nesoi",October,2017,Q4,October 2017,-1750739494,201126979,1951866473
"Fabricated Metal Products, Nesoi",November,2017,Q4,November 2017,-1676034208,185900771,1861934979
"Fabricated Metal Products, Nesoi",December,2017,Q4,December 2017,-1756697852,205021615,1961719467
"Fabricated Metal Products, Nesoi",January,2018,Q1,January 2018,-2020790590,175314751,2196105341
"Fabricated Metal Products, Nesoi",February,2018,Q1,February 2018,-1894073240,161312259,2055385499
"Fabricated Metal Products, Nesoi",March,2018,Q1,March 2018,-1542767751,233358770,1776126521
"Fabricated Metal Products, Nesoi",April,2018,Q2,April 2018,-1555455146,200362566,1755817712
"Fabricated Metal Products, Nesoi",May,2018,Q2,May 2018,-2012465631,211272482,2223738113
"Fabricated Metal Products, Nesoi",June,2018,Q2,June 2018,-2068794745,229375961,2298170706
"Fabricated Metal Products, Nesoi",July,2018,Q3,July 2018,-2131010341,202437824,2333448165
"Fabricated Metal Products, Nesoi",August,2018,Q3,August 2018,-2092823024,206690428,2299513452
"Fabricated Metal Products, Nesoi",September,2018,Q3,September 2018,-2036225889,201934180,2238160069
"Fabricated Metal Products, Nesoi",October,2018,Q4,October 2018,-2246010143,215745062,2461755205
"Fabricated Metal Products, Nesoi",November,2018,Q4,November 2018,-2019876140,190645973,2210522113
"Fabricated Metal Products, Nesoi",December,2018,Q4,December 2018,-2332320554,196010155,2528330709
"Fabricated Metal Products, Nesoi",January,2019,Q1,January 2019,-2130220811,161623219,2291844030
"Fabricated Metal Products, Nesoi",February,2019,Q1,February 2019,-1751269936,158381547,1909651483
"Fabricated Metal Products, Nesoi",March,2019,Q1,March 2019,-1309790834,196931368,1506722202
"Fabricated Metal Products, Nesoi",April,2019,Q2,April 2019,-1641532165,183833833,1825365998
"Fabricated Metal Products, Nesoi",May,2019,Q2,May 2019,-1876537852,208039742,2084577594
"Fabricated Metal Products, Nesoi",June,2019,Q2,June 2019,-1801414122,183729592,1985143714
"Fabricated Metal Products, Nesoi",July,2019,Q3,July 2019,-1920014442,168435634,2088450076
"Fabricated Metal Products, Nesoi",August,2019,Q3,August 2019,-1891415274,177972680,2069387954
"Fabricated Metal Products, Nesoi",September,2019,Q3,September 2019,-1737012962,174164037,1911176999
"Fabricated Metal Products, Nesoi",October,2019,Q4,October 2019,-1674740852,212904293,1887645145
"Fabricated Metal Products, Nesoi",November,2019,Q4,November 2019,-1522700046,176334379,1699034425
"Fabricated Metal Products, Nesoi",December,2019,Q4,December 2019,-1547402214,180961118,1728363332
"Machinery, Except Electrical",January,2002,Q1,January 2002,-173868131,156836233,330704364
"Machinery, Except Electrical",February,2002,Q1,February 2002,-180198075,158798357,338996432
"Machinery, Except Electrical",March,2002,Q1,March 2002,-190644124,192334227,382978351
"Machinery, Except Electrical",April,2002,Q2,April 2002,-236062056,232787020,468849076
"Machinery, Except Electrical",May,2002,Q2,May 2002,-263153087,260338814,523491901
"Machinery, Except Electrical",June,2002,Q2,June 2002,-197493042,301887229,499380271
"Machinery, Except Electrical",July,2002,Q3,July 2002,-146361542,280652199,427013741
"Machinery, Except Electrical",August,2002,Q3,August 2002,-222737505,278284254,501021759
"Machinery, Except Electrical",September,2002,Q3,September 2002,-265469654,254406424,519876078
"Machinery, Except Electrical",October,2002,Q4,October 2002,-241967509,243511204,485478713
"Machinery, Except Electrical",November,2002,Q4,November 2002,-282848442,273988455,556836897
"Machinery, Except Electrical",December,2002,Q4,December 2002,-294135143,248274271,542409414
"Machinery, Except Electrical",January,2003,Q1,January 2003,-356884392,199331830,556216222
"Machinery, Except Electrical",February,2003,Q1,February 2003,-314825474,216425635,531251109
"Machinery, Except Electrical",March,2003,Q1,March 2003,-310721742,297164610,607886352
"Machinery, Except Electrical",April,2003,Q2,April 2003,-496790964,240224617,737015581
"Machinery, Except Electrical",May,2003,Q2,May 2003,-534129849,242577305,776707154
"Machinery, Except Electrical",June,2003,Q2,June 2003,-425682891,285326771,711009662
"Machinery, Except Electrical",July,2003,Q3,July 2003,-377563246,267805745,645368991
"Machinery, Except Electrical",August,2003,Q3,August 2003,-422782574,233628707,656411281
"Machinery, Except Electrical",September,2003,Q3,September 2003,-502208179,252180899,754389078
"Machinery, Except Electrical",October,2003,Q4,October 2003,-546271258,318186633,864457891
"Machinery, Except Electrical",November,2003,Q4,November 2003,-479966132,303898934,783865066
"Machinery, Except Electrical",December,2003,Q4,December 2003,-384430983,326384801,710815784
"Machinery, Except Electrical",January,2004,Q1,January 2004,-445725439,296382504,742107943
"Machinery, Except Electrical",February,2004,Q1,February 2004,-287815823,349820096,637635919
"Machinery, Except Electrical",March,2004,Q1,March 2004,-425869501,428306884,854176385
"Machinery, Except Electrical",April,2004,Q2,April 2004,-473896854,457039127,930935981
"Machinery, Except Electrical",May,2004,Q2,May 2004,-530736257,441507126,972243383
"Machinery, Except Electrical",June,2004,Q2,June 2004,-312384148,630569000,942953148
"Machinery, Except Electrical",July,2004,Q3,July 2004,-418557145,436377835,854934980
"Machinery, Except Electrical",August,2004,Q3,August 2004,-514870179,419135806,934005985
"Machinery, Except Electrical",September,2004,Q3,September 2004,-591575419,360224261,951799680
"Machinery, Except Electrical",October,2004,Q4,October 2004,-712999308,350336341,1063335649
"Machinery, Except Electrical",November,2004,Q4,November 2004,-892560115,321844314,1214404429
"Machinery, Except Electrical",December,2004,Q4,December 2004,-594882802,502232826,1097115628
"Machinery, Except Electrical",January,2005,Q1,January 2005,-570971063,416979994,987951057
"Machinery, Except Electrical",February,2005,Q1,February 2005,-742113356,341691459,1083804815
"Machinery, Except Electrical",March,2005,Q1,March 2005,-761528086,406789329,1168317415
"Machinery, Except Electrical",April,2005,Q2,April 2005,-910450541,367887683,1278338224
"Machinery, Except Electrical",May,2005,Q2,May 2005,-856224747,399969562,1256194309
"Machinery, Except Electrical",June,2005,Q2,June 2005,-876416661,360027422,1236444083
"Machinery, Except Electrical",July,2005,Q3,July 2005,-749237825,406162232,1155400057
"Machinery, Except Electrical",August,2005,Q3,August 2005,-784209904,407966161,1192176065
"Machinery, Except Electrical",September,2005,Q3,September 2005,-868563725,394954971,1263518696
"Machinery, Except Electrical",October,2005,Q4,October 2005,-873869401,463652034,1337521435
"Machinery, Except Electrical",November,2005,Q4,November 2005,-1041827345,383484063,1425311408
"Machinery, Except Electrical",December,2005,Q4,December 2005,-936477571,462413628,1398891199
"Machinery, Except Electrical",January,2006,Q1,January 2006,-902296280,345965261,1248261541
"Machinery, Except Electrical",February,2006,Q1,February 2006,-759130397,395504421,1154634818
"Machinery, Except Electrical",March,2006,Q1,March 2006,-781994154,538545701,1320539855
"Machinery, Except Electrical",April,2006,Q2,April 2006,-1010727368,478559130,1489286498
"Machinery, Except Electrical",May,2006,Q2,May 2006,-1091221099,450456832,1541677931
"Machinery, Except Electrical",June,2006,Q2,June 2006,-810536655,566117022,1376653677
"Machinery, Except Electrical",July,2006,Q3,July 2006,-712451325,540071026,1252522351
"Machinery, Except Electrical",August,2006,Q3,August 2006,-764424535,609497216,1373921751
"Machinery, Except Electrical",September,2006,Q3,September 2006,-1031993927,453644049,1485637976
"Machinery, Except Electrical",October,2006,Q4,October 2006,-1243995858,497778818,1741774676
"Machinery, Except Electrical",November,2006,Q4,November 2006,-1318900879,445445609,1764346488
"Machinery, Except Electrical",December,2006,Q4,December 2006,-1029229991,454138864,1483368855
"Machinery, Except Electrical",January,2007,Q1,January 2007,-1052973458,476131333,1529104791
"Machinery, Except Electrical",February,2007,Q1,February 2007,-970533727,446999326,1417533053
"Machinery, Except Electrical",March,2007,Q1,March 2007,-701098667,744414734,1445513401
"Machinery, Except Electrical",April,2007,Q2,April 2007,-1016662150,667944208,1684606358
"Machinery, Except Electrical",May,2007,Q2,May 2007,-980516349,670374549,1650890898
"Machinery, Except Electrical",June,2007,Q2,June 2007,-872846169,628510321,1501356490
"Machinery, Except Electrical",July,2007,Q3,July 2007,-846752795,604672647,1451425442
"Machinery, Except Electrical",August,2007,Q3,August 2007,-871260124,539148941,1410409065
"Machinery, Except Electrical",September,2007,Q3,September 2007,-774741130,581583240,1356324370
"Machinery, Except Electrical",October,2007,Q4,October 2007,-893620301,563975506,1457595807
"Machinery, Except Electrical",November,2007,Q4,November 2007,-919881131,541401809,1461282940
"Machinery, Except Electrical",December,2007,Q4,December 2007,-600418366,609848250,1210266616
"Machinery, Except Electrical",January,2008,Q1,January 2008,-726313134,526035785,1252348919
"Machinery, Except Electrical",February,2008,Q1,February 2008,-745769665,554800305,1300569970
"Machinery, Except Electrical",March,2008,Q1,March 2008,-525121777,703974755,1229096532
"Machinery, Except Electrical",April,2008,Q2,April 2008,-849723453,624684373,1474407826
"Machinery, Except Electrical",May,2008,Q2,May 2008,-979958674,641737577,1621696251
"Machinery, Except Electrical",June,2008,Q2,June 2008,-762724775,664018403,1426743178
"Machinery, Except Electrical",July,2008,Q3,July 2008,-683398554,721477472,1404876026
"Machinery, Except Electrical",August,2008,Q3,August 2008,-849514050,631772123,1481286173
"Machinery, Except Electrical",September,2008,Q3,September 2008,-821257412,635952183,1457209595
"Machinery, Except Electrical",October,2008,Q4,October 2008,-848122310,654849338,1502971648
"Machinery, Except Electrical",November,2008,Q4,November 2008,-743659501,593777891,1337437392
"Machinery, Except Electrical",December,2008,Q4,December 2008,-669527921,566213688,1235741609
"Machinery, Except Electrical",January,2009,Q1,January 2009,-884890652,379498936,1264389588
"Machinery, Except Electrical",February,2009,Q1,February 2009,-641644765,418658030,1060302795
"Machinery, Except Electrical",March,2009,Q1,March 2009,-521357158,678324216,1199681374
"Machinery, Except Electrical",April,2009,Q2,April 2009,-704310612,563381382,1267691994
"Machinery, Except Electrical",May,2009,Q2,May 2009,-751821024,516396186,1268217210
"Machinery, Except Electrical",June,2009,Q2,June 2009,-454892041,581288703,1036180744
"Machinery, Except Electrical",July,2009,Q3,July 2009,-612152089,494297648,1106449737
"Machinery, Except Electrical",August,2009,Q3,August 2009,-579610156,495609341,1075219497
"Machinery, Except Electrical",September,2009,Q3,September 2009,-700179922,498128528,1198308450
"Machinery, Except Electrical",October,2009,Q4,October 2009,-636352748,610678606,1247031354
"Machinery, Except Electrical",November,2009,Q4,November 2009,-545034597,577684480,1122719077
"Machinery, Except Electrical",December,2009,Q4,December 2009,-469466843,641719264,1111186107
"Machinery, Except Electrical",January,2010,Q1,January 2010,-608863352,528867479,1137730831
"Machinery, Except Electrical",February,2010,Q1,February 2010,-416239846,625745538,1041985384
"Machinery, Except Electrical",March,2010,Q1,March 2010,-538379436,744148669,1282528105
"Machinery, Except Electrical",April,2010,Q2,April 2010,-664431420,711714911,1376146331
"Machinery, Except Electrical",May,2010,Q2,May 2010,-811596765,758587783,1570184548
"Machinery, Except Electrical",June,2010,Q2,June 2010,-933697099,698679385,1632376484
"Machinery, Except Electrical",July,2010,Q3,July 2010,-703726423,835001768,1538728191
"Machinery, Except Electrical",August,2010,Q3,August 2010,-805098710,793558531,1598657241
"Machinery, Except Electrical",September,2010,Q3,September 2010,-706767576,828523804,1535291380
"Machinery, Except Electrical",October,2010,Q4,October 2010,-654526047,856307857,1510833904
"Machinery, Except Electrical",November,2010,Q4,November 2010,-638531782,759110734,1397642516
"Machinery, Except Electrical",December,2010,Q4,December 2010,-209284322,1161251460,1370535782
"Machinery, Except Electrical",January,2011,Q1,January 2011,-843564023,752948169,1596512192
"Machinery, Except Electrical",February,2011,Q1,February 2011,-768050043,755161454,1523211497
"Machinery, Except Electrical",March,2011,Q1,March 2011,-450025479,1047567427,1497592906
"Machinery, Except Electrical",April,2011,Q2,April 2011,-869866977,958213559,1828080536
"Machinery, Except Electrical",May,2011,Q2,May 2011,-1016151890,930072097,1946223987
"Machinery, Except Electrical",June,2011,Q2,June 2011,-803379885,1008998222,1812378107
"Machinery, Except Electrical",July,2011,Q3,July 2011,-835328471,865916667,1701245138
"Machinery, Except Electrical",August,2011,Q3,August 2011,-783743445,1041984781,1825728226
"Machinery, Except Electrical",September,2011,Q3,September 2011,-911975883,899937245,1811913128
"Machinery, Except Electrical",October,2011,Q4,October 2011,-886976432,830418157,1717394589
"Machinery, Except Electrical",November,2011,Q4,November 2011,-892740173,763542371,1656282544
"Machinery, Except Electrical",December,2011,Q4,December 2011,-777858497,882697850,1660556347
"Machinery, Except Electrical",January,2012,Q1,January 2012,-1521563508,578428372,2099991880
"Machinery, Except Electrical",February,2012,Q1,February 2012,-1184094727,630672997,1814767724
"Machinery, Except Electrical",March,2012,Q1,March 2012,-1386967272,767451088,2154418360
"Machinery, Except Electrical",April,2012,Q2,April 2012,-1641966541,773033567,2415000108
"Machinery, Except Electrical",May,2012,Q2,May 2012,-1681117307,878987187,2560104494
"Machinery, Except Electrical",June,2012,Q2,June 2012,-1464504730,928887604,2393392334
"Machinery, Except Electrical",July,2012,Q3,July 2012,-1399713461,903911911,2303625372
"Machinery, Except Electrical",August,2012,Q3,August 2012,-1316004848,847320892,2163325740
"Machinery, Except Electrical",September,2012,Q3,September 2012,-1250865460,843638067,2094503527
"Machinery, Except Electrical",October,2012,Q4,October 2012,-1254321883,768987315,2023309198
"Machinery, Except Electrical",November,2012,Q4,November 2012,-1138622775,714860572,1853483347
"Machinery, Except Electrical",December,2012,Q4,December 2012,-1091078359,789954291,1881032650
"Machinery, Except Electrical",January,2013,Q1,January 2013,-1491863494,680039247,2171902741
"Machinery, Except Electrical",February,2013,Q1,February 2013,-1494758880,594477603,2089236483
"Machinery, Except Electrical",March,2013,Q1,March 2013,-1107850167,821697558,1929547725
"Machinery, Except Electrical",April,2013,Q2,April 2013,-1514870714,867822471,2382693185
"Machinery, Except Electrical",May,2013,Q2,May 2013,-1660547076,842624011,2503171087
"Machinery, Except Electrical",June,2013,Q2,June 2013,-1404332926,819905314,2224238240
"Machinery, Except Electrical",July,2013,Q3,July 2013,-1487022646,752189631,2239212277
"Machinery, Except Electrical",August,2013,Q3,August 2013,-1420160770,860363042,2280523812
"Machinery, Except Electrical",September,2013,Q3,September 2013,-1561637664,643636412,2205274076
"Machinery, Except Electrical",October,2013,Q4,October 2013,-1409142870,766221549,2175364419
"Machinery, Except Electrical",November,2013,Q4,November 2013,-1255805796,800434974,2056240770
"Machinery, Except Electrical",December,2013,Q4,December 2013,-1088284532,1058072944,2146357476
"Machinery, Except Electrical",January,2014,Q1,January 2014,-1809800636,700662917,2510463553
"Machinery, Except Electrical",February,2014,Q1,February 2014,-1473266031,678479600,2151745631
"Machinery, Except Electrical",March,2014,Q1,March 2014,-1352891214,977110633,2330001847
"Machinery, Except Electrical",April,2014,Q2,April 2014,-1969002732,764466787,2733469519
"Machinery, Except Electrical",May,2014,Q2,May 2014,-2049804288,811371133,2861175421
"Machinery, Except Electrical",June,2014,Q2,June 2014,-1624447880,939519899,2563967779
"Machinery, Except Electrical",July,2014,Q3,July 2014,-1702244199,821075554,2523319753
"Machinery, Except Electrical",August,2014,Q3,August 2014,-1676104986,763273327,2439378313
"Machinery, Except Electrical",September,2014,Q3,September 2014,-1790204592,676403927,2466608519
"Machinery, Except Electrical",October,2014,Q4,October 2014,-1475951028,1035859909,2511810937
"Machinery, Except Electrical",November,2014,Q4,November 2014,-1410936972,729621247,2140558219
"Machinery, Except Electrical",December,2014,Q4,December 2014,-1581903070,787919196,2369822266
"Machinery, Except Electrical",January,2015,Q1,January 2015,-1874673289,665745214,2540418503
"Machinery, Except Electrical",February,2015,Q1,February 2015,-1350217995,712329009,2062547004
"Machinery, Except Electrical",March,2015,Q1,March 2015,-2150752337,965677932,3116430269
"Machinery, Except Electrical",April,2015,Q2,April 2015,-1955349940,858387605,2813737545
"Machinery, Except Electrical",May,2015,Q2,May 2015,-1992362713,784848316,2777211029
"Machinery, Except Electrical",June,2015,Q2,June 2015,-1916914023,764926793,2681840816
"Machinery, Except Electrical",July,2015,Q3,July 2015,-1653679840,870792202,2524472042
"Machinery, Except Electrical",August,2015,Q3,August 2015,-1672267895,926459991,2598727886
"Machinery, Except Electrical",September,2015,Q3,September 2015,-1833463201,738478175,2571941376
"Machinery, Except Electrical",October,2015,Q4,October 2015,-1815967510,606818203,2422785713
"Machinery, Except Electrical",November,2015,Q4,November 2015,-1661624605,555641179,2217265784
"Machinery, Except Electrical",December,2015,Q4,December 2015,-1553165839,737231348,2290397187
"Machinery, Except Electrical",January,2016,Q1,January 2016,-1852605182,684747998,2537353180
"Machinery, Except Electrical",February,2016,Q1,February 2016,-2042624341,539867047,2582491388
"Machinery, Except Electrical",March,2016,Q1,March 2016,-1459299258,885595497,2344894755
"Machinery, Except Electrical",April,2016,Q2,April 2016,-1786945197,853374704,2640319901
"Machinery, Except Electrical",May,2016,Q2,May 2016,-2140986414,645104814,2786091228
"Machinery, Except Electrical",June,2016,Q2,June 2016,-1918430078,644346196,2562776274
"Machinery, Except Electrical",July,2016,Q3,July 2016,-1742828417,633277119,2376105536
"Machinery, Except Electrical",August,2016,Q3,August 2016,-2085725959,649957376,2735683335
"Machinery, Except Electrical",September,2016,Q3,September 2016,-1851496039,581590088,2433086127
"Machinery, Except Electrical",October,2016,Q4,October 2016,-1684392849,781219624,2465612473
"Machinery, Except Electrical",November,2016,Q4,November 2016,-1812651141,578373934,2391025075
"Machinery, Except Electrical",December,2016,Q4,December 2016,-1771250473,811867239,2583117712
"Machinery, Except Electrical",January,2017,Q1,January 2017,-2161018411,709706467,2870724878
"Machinery, Except Electrical",February,2017,Q1,February 2017,-1884770612,676751996,2561522608
"Machinery, Except Electrical",March,2017,Q1,March 2017,-2033389649,792498781,2825888430
"Machinery, Except Electrical",April,2017,Q2,April 2017,-2149628998,841358600,2990987598
"Machinery, Except Electrical",May,2017,Q2,May 2017,-2405052128,838240713,3243292841
"Machinery, Except Electrical",June,2017,Q2,June 2017,-2151231927,812884664,2964116591
"Machinery, Except Electrical",July,2017,Q3,July 2017,-2215134212,728871033,2944005245
"Machinery, Except Electrical",August,2017,Q3,August 2017,-2311351180,716257063,3027608243
"Machinery, Except Electrical",September,2017,Q3,September 2017,-2160555431,732971816,2893527247
"Machinery, Except Electrical",October,2017,Q4,October 2017,-2108921154,810547465,2919468619
"Machinery, Except Electrical",November,2017,Q4,November 2017,-2151621673,708059692,2859681365
"Machinery, Except Electrical",December,2017,Q4,December 2017,-1928279092,1018833633,2947112725
"Machinery, Except Electrical",January,2018,Q1,January 2018,-2695693992,668831538,3364525530
"Machinery, Except Electrical",February,2018,Q1,February 2018,-2350239102,685443303,3035682405
"Machinery, Except Electrical",March,2018,Q1,March 2018,-2333000741,998401529,3331402270
"Machinery, Except Electrical",April,2018,Q2,April 2018,-2261276522,982690467,3243966989
"Machinery, Except Electrical",May,2018,Q2,May 2018,-2415889928,1088576201,3504466129
"Machinery, Except Electrical",June,2018,Q2,June 2018,-2173314805,1183601924,3356916729
"Machinery, Except Electrical",July,2018,Q3,July 2018,-1962805698,1143611235,3106416933
"Machinery, Except Electrical",August,2018,Q3,August 2018,-2258442459,939078197,3197520656
"Machinery, Except Electrical",September,2018,Q3,September 2018,-2209885515,888008795,3097894310
"Machinery, Except Electrical",October,2018,Q4,October 2018,-2309664526,824543301,3134207827
"Machinery, Except Electrical",November,2018,Q4,November 2018,-2158693136,737009133,2895702269
"Machinery, Except Electrical",December,2018,Q4,December 2018,-2493205829,945935142,3439140971
"Machinery, Except Electrical",January,2019,Q1,January 2019,-2573698662,644926158,3218624820
"Machinery, Except Electrical",February,2019,Q1,February 2019,-2047353668,590591509,2637945177
"Machinery, Except Electrical",March,2019,Q1,March 2019,-1855979734,908157700,2764137434
"Machinery, Except Electrical",April,2019,Q2,April 2019,-1909738667,1012874102,2922612769
"Machinery, Except Electrical",May,2019,Q2,May 2019,-1951847323,1024301826,2976149149
"Machinery, Except Electrical",June,2019,Q2,June 2019,-1550279241,1076051992,2626331233
"Machinery, Except Electrical",July,2019,Q3,July 2019,-1973945769,898485265,2872431034
"Machinery, Except Electrical",August,2019,Q3,August 2019,-1982475200,873847875,2856323075
"Machinery, Except Electrical",September,2019,Q3,September 2019,-1935085232,707977963,2643063195
"Machinery, Except Electrical",October,2019,Q4,October 2019,-1639254546,862546734,2501801280
"Machinery, Except Electrical",November,2019,Q4,November 2019,-1476877635,805079416,2281957051
"Machinery, Except Electrical",December,2019,Q4,December 2019,-1541133079,1033620936,2574754015
Computer & Electronics,January,2002,Q1,January 2002,-1640523592,393050486,2033574078
Computer & Electronics,February,2002,Q1,February 2002,-1660127327,328693227,1988820554
Computer & Electronics,March,2002,Q1,March 2002,-1537610910,434101020,1971711930
Computer & Electronics,April,2002,Q2,April 2002,-2001510874,418367679,2419878553
Computer & Electronics,May,2002,Q2,May 2002,-2034265548,450032848,2484298396
Computer & Electronics,June,2002,Q2,June 2002,-2366417930,507321649,2873739579
Computer & Electronics,July,2002,Q3,July 2002,-2389713498,453865884,2843579382
Computer & Electronics,August,2002,Q3,August 2002,-2673774088,486911042,3160685130
Computer & Electronics,September,2002,Q3,September 2002,-2685827712,443650833,3129478545
Computer & Electronics,October,2002,Q4,October 2002,-2716618160,453396961,3170015121
Computer & Electronics,November,2002,Q4,November 2002,-3475087594,467610962,3942698556
Computer & Electronics,December,2002,Q4,December 2002,-2823070359,481625988,3304696347
Computer & Electronics,January,2003,Q1,January 2003,-2352783459,395223472,2748006931
Computer & Electronics,February,2003,Q1,February 2003,-1930793027,370746639,2301539666
Computer & Electronics,March,2003,Q1,March 2003,-2324807812,526575892,2851383704
Computer & Electronics,April,2003,Q2,April 2003,-2638588331,521399412,3159987743
Computer & Electronics,May,2003,Q2,May 2003,-2705729427,518271794,3224001221
Computer & Electronics,June,2003,Q2,June 2003,-2890865261,546779716,3437644977
Computer & Electronics,July,2003,Q3,July 2003,-3105278613,598220934,3703499547
Computer & Electronics,August,2003,Q3,August 2003,-3180981190,581797390,3762778580
Computer & Electronics,September,2003,Q3,September 2003,-3731579629,555346254,4286925883
Computer & Electronics,October,2003,Q4,October 2003,-4478067768,622693524,5100761292
Computer & Electronics,November,2003,Q4,November 2003,-4241500920,600771113,4842272033
Computer & Electronics,December,2003,Q4,December 2003,-3779670876,670456431,4450127307
Computer & Electronics,January,2004,Q1,January 2004,-3586853325,546490029,4133343354
Computer & Electronics,February,2004,Q1,February 2004,-2982849761,617665335,3600515096
Computer & Electronics,March,2004,Q1,March 2004,-3974218988,676658490,4650877478
Computer & Electronics,April,2004,Q2,April 2004,-4071297927,647489764,4718787691
Computer & Electronics,May,2004,Q2,May 2004,-3908935516,720324122,4629259638
Computer & Electronics,June,2004,Q2,June 2004,-4755456114,684597890,5440054004
Computer & Electronics,July,2004,Q3,July 2004,-4946528358,655249806,5601778164
Computer & Electronics,August,2004,Q3,August 2004,-5119779454,633521413,5753300867
Computer & Electronics,September,2004,Q3,September 2004,-5020357451,688935828,5709293279
Computer & Electronics,October,2004,Q4,October 2004,-6098070623,646574714,6744645337
Computer & Electronics,November,2004,Q4,November 2004,-6466313217,582730227,7049043444
Computer & Electronics,December,2004,Q4,December 2004,-5342214071,674279865,6016493936
Computer & Electronics,January,2005,Q1,January 2005,-4850602571,577012426,5427614997
Computer & Electronics,February,2005,Q1,February 2005,-4249165308,537505082,4786670390
Computer & Electronics,March,2005,Q1,March 2005,-4704698696,721559147,5426257843
Computer & Electronics,April,2005,Q2,April 2005,-5101003400,633060839,5734064239
Computer & Electronics,May,2005,Q2,May 2005,-5239930693,635260704,5875191397
Computer & Electronics,June,2005,Q2,June 2005,-5982889547,693940085,6676829632
Computer & Electronics,July,2005,Q3,July 2005,-6072765171,708936966,6781702137
Computer & Electronics,August,2005,Q3,August 2005,-6320382148,715446640,7035828788
Computer & Electronics,September,2005,Q3,September 2005,-6837008474,778727734,7615736208
Computer & Electronics,October,2005,Q4,October 2005,-7528974454,917190753,8446165207
Computer & Electronics,November,2005,Q4,November 2005,-7580388430,856719848,8437108278
Computer & Electronics,December,2005,Q4,December 2005,-6388480618,1073398564,7461879182
Computer & Electronics,January,2006,Q1,January 2006,-6342862744,760150244,7103012988
Computer & Electronics,February,2006,Q1,February 2006,-4849045106,950992859,5800037965
Computer & Electronics,March,2006,Q1,March 2006,-6750087661,1083727621,7833815282
Computer & Electronics,April,2006,Q2,April 2006,-6067308138,939717782,7007025920
Computer & Electronics,May,2006,Q2,May 2006,-5895377840,1066888778,6962266618
Computer & Electronics,June,2006,Q2,June 2006,-6961036472,1115453308,8076489780
Computer & Electronics,July,2006,Q3,July 2006,-7098990364,1040338538,8139328902
Computer & Electronics,August,2006,Q3,August 2006,-6924699769,1191648955,8116348724
Computer & Electronics,September,2006,Q3,September 2006,-7822443187,1118238257,8940681444
Computer & Electronics,October,2006,Q4,October 2006,-8747192963,1091738942,9838931905
Computer & Electronics,November,2006,Q4,November 2006,-8866612409,1057807580,9924419989
Computer & Electronics,December,2006,Q4,December 2006,-6921643233,1157434715,8079077948
Computer & Electronics,January,2007,Q1,January 2007,-7254005898,1000336036,8254341934
Computer & Electronics,February,2007,Q1,February 2007,-6223582976,874953874,7098536850
Computer & Electronics,March,2007,Q1,March 2007,-6799740948,1227002938,8026743886
Computer & Electronics,April,2007,Q2,April 2007,-7188158303,946286393,8134444696
Computer & Electronics,May,2007,Q2,May 2007,-6604005370,1188687229,7792692599
Computer & Electronics,June,2007,Q2,June 2007,-7798754096,1261107823,9059861919
Computer & Electronics,July,2007,Q3,July 2007,-7988458058,1018148187,9006606245
Computer & Electronics,August,2007,Q3,August 2007,-7523600937,1101840091,8625441028
Computer & Electronics,September,2007,Q3,September 2007,-8458114293,1188147103,9646261396
Computer & Electronics,October,2007,Q4,October 2007,-9718454242,1183636357,10902090599
Computer & Electronics,November,2007,Q4,November 2007,-9853569523,1091746805,10945316328
Computer & Electronics,December,2007,Q4,December 2007,-8018499140,1184591333,9203090473
Computer & Electronics,January,2008,Q1,January 2008,-7070364563,1049098207,8119462770
Computer & Electronics,February,2008,Q1,February 2008,-6151152999,979449687,7130602686
Computer & Electronics,March,2008,Q1,March 2008,-7069995652,1220297827,8290293479
Computer & Electronics,April,2008,Q2,April 2008,-7778729773,1131136516,8909866289
Computer & Electronics,May,2008,Q2,May 2008,-7466281263,1306968986,8773250249
Computer & Electronics,June,2008,Q2,June 2008,-8013114829,1218028685,9231143514
Computer & Electronics,July,2008,Q3,July 2008,-8962106614,1287729057,10249835671
Computer & Electronics,August,2008,Q3,August 2008,-8410281553,1222792757,9633074310
Computer & Electronics,September,2008,Q3,September 2008,-9082276916,1193514246,10275791162
Computer & Electronics,October,2008,Q4,October 2008,-9506023237,1183570188,10689593425
Computer & Electronics,November,2008,Q4,November 2008,-7842108611,1084053814,8926162425
Computer & Electronics,December,2008,Q4,December 2008,-6758116089,994466353,7752582442
Computer & Electronics,January,2009,Q1,January 2009,-5915106744,752682640,6667789384
Computer & Electronics,February,2009,Q1,February 2009,-4952210245,817613315,5769823560
Computer & Electronics,March,2009,Q1,March 2009,-6433134647,1078173306,7511307953
Computer & Electronics,April,2009,Q2,April 2009,-6347386219,933667400,7281053619
Computer & Electronics,May,2009,Q2,May 2009,-6549818399,970943480,7520761879
Computer & Electronics,June,2009,Q2,June 2009,-8102174399,1037390528,9139564927
Computer & Electronics,July,2009,Q3,July 2009,-7773219732,1093246165,8866465897
Computer & Electronics,August,2009,Q3,August 2009,-7412735231,1090389887,8503125118
Computer & Electronics,September,2009,Q3,September 2009,-8365896922,1141729173,9507626095
Computer & Electronics,October,2009,Q4,October 2009,-9662343651,1190698282,10853041933
Computer & Electronics,November,2009,Q4,November 2009,-10114697899,1052803245,11167501144
Computer & Electronics,December,2009,Q4,December 2009,-9196784774,1370843407,10567628181
Computer & Electronics,January,2010,Q1,January 2010,-7610073213,1180046180,8790119393
Computer & Electronics,February,2010,Q1,February 2010,-7073522388,1006999291,8080521679
Computer & Electronics,March,2010,Q1,March 2010,-7860373538,1320396443,9180769981
Computer & Electronics,April,2010,Q2,April 2010,-8528882500,1242915035,9771797535
Computer & Electronics,May,2010,Q2,May 2010,-9245961962,1343311386,10589273348
Computer & Electronics,June,2010,Q2,June 2010,-10963580478,1375374992,12338955470
Computer & Electronics,July,2010,Q3,July 2010,-10419375230,1286783406,11706158636
Computer & Electronics,August,2010,Q3,August 2010,-10599767622,1217317973,11817085595
Computer & Electronics,September,2010,Q3,September 2010,-10996786947,1211072767,12207859714
Computer & Electronics,October,2010,Q4,October 2010,-10853677072,1314298760,12167975832
Computer & Electronics,November,2010,Q4,November 2010,-12771203284,1282243792,14053447076
Computer & Electronics,December,2010,Q4,December 2010,-10611879620,1454579313,12066458933
Computer & Electronics,January,2011,Q1,January 2011,-9592829687,1138806732,10731636419
Computer & Electronics,February,2011,Q1,February 2011,-8269400646,1031574633,9300975279
Computer & Electronics,March,2011,Q1,March 2011,-10536234632,1343768853,11880003485
Computer & Electronics,April,2011,Q2,April 2011,-9553180047,1128390963,10681571010
Computer & Electronics,May,2011,Q2,May 2011,-10521986197,1184833365,11706819562
Computer & Electronics,June,2011,Q2,June 2011,-11507164695,1208228296,12715392991
Computer & Electronics,July,2011,Q3,July 2011,-11148618586,1148790498,12297409084
Computer & Electronics,August,2011,Q3,August 2011,-11294458266,1060415706,12354873972
Computer & Electronics,September,2011,Q3,September 2011,-10954333218,1117589923,12071923141
Computer & Electronics,October,2011,Q4,October 2011,-13341113457,1098335138,14439448595
Computer & Electronics,November,2011,Q4,November 2011,-13522255024,1097593095,14619848119
Computer & Electronics,December,2011,Q4,December 2011,-11790939912,1231469848,13022409760
Computer & Electronics,January,2012,Q1,January 2012,-10112259447,876272220,10988531667
Computer & Electronics,February,2012,Q1,February 2012,-9123717307,965064538,10088781845
Computer & Electronics,March,2012,Q1,March 2012,-11952454765,1139582795,13092037560
Computer & Electronics,April,2012,Q2,April 2012,-10351812958,1052742653,11404555611
Computer & Electronics,May,2012,Q2,May 2012,-10780034769,1276993949,12057028718
Computer & Electronics,June,2012,Q2,June 2012,-11338777922,1413947325,12752725247
Computer & Electronics,July,2012,Q3,July 2012,-11586749543,1234050954,12820800497
Computer & Electronics,August,2012,Q3,August 2012,-10873939522,1277928447,12151867969
Computer & Electronics,September,2012,Q3,September 2012,-11819798195,1202716166,13022514361
Computer & Electronics,October,2012,Q4,October 2012,-13956019778,1149217506,15105237284
Computer & Electronics,November,2012,Q4,November 2012,-16227647427,1056290015,17283937442
Computer & Electronics,December,2012,Q4,December 2012,-12354183588,1277172174,13631355762
Computer & Electronics,January,2013,Q1,January 2013,-11720258881,1091616031,12811874912
Computer & Electronics,February,2013,Q1,February 2013,-9546037432,926506657,10472544089
Computer & Electronics,March,2013,Q1,March 2013,-9394963204,1513264927,10908228131
Computer & Electronics,April,2013,Q2,April 2013,-10759874762,1259722375,12019597137
Computer & Electronics,May,2013,Q2,May 2013,-12119690286,1486873803,13606564089
Computer & Electronics,June,2013,Q2,June 2013,-11453889982,1565129970,13019019952
Computer & Electronics,July,2013,Q3,July 2013,-11670176258,1387658046,13057834304
Computer & Electronics,August,2013,Q3,August 2013,-11163441138,1428504827,12591945965
Computer & Electronics,September,2013,Q3,September 2013,-12552524656,1199382517,13751907173
Computer & Electronics,October,2013,Q4,October 2013,-13497857117,1442611211,14940468328
Computer & Electronics,November,2013,Q4,November 2013,-15750209607,1272088415,17022298022
Computer & Electronics,December,2013,Q4,December 2013,-13399634209,1452281221,14851915430
Computer & Electronics,January,2014,Q1,January 2014,-11117695699,1119513011,12237208710
Computer & Electronics,February,2014,Q1,February 2014,-8532273176,1137656599,9669929775
Computer & Electronics,March,2014,Q1,March 2014,-10547485697,1325061583,11872547280
Computer & Electronics,April,2014,Q2,April 2014,-11977582544,1268307452,13245889996
Computer & Electronics,May,2014,Q2,May 2014,-12147794455,1426337088,13574131543
Computer & Electronics,June,2014,Q2,June 2014,-12608179850,1499202420,14107382270
Computer & Electronics,July,2014,Q3,July 2014,-11757121925,1398940108,13156062033
Computer & Electronics,August,2014,Q3,August 2014,-11250421101,1521291703,12771712804
Computer & Electronics,September,2014,Q3,September 2014,-14677519221,1371593582,16049112803
Computer & Electronics,October,2014,Q4,October 2014,-15209183465,1435753740,16644937205
Computer & Electronics,November,2014,Q4,November 2014,-17261274202,1301355560,18562629762
Computer & Electronics,December,2014,Q4,December 2014,-14836954142,1551261205,16388215347
Computer & Electronics,January,2015,Q1,January 2015,-11867086389,1424636302,13291722691
Computer & Electronics,February,2015,Q1,February 2015,-9091886231,1085275162,10177161393
Computer & Electronics,March,2015,Q1,March 2015,-12448692004,1503136648,13951828652
Computer & Electronics,April,2015,Q2,April 2015,-11432337839,1367612656,12799950495
Computer & Electronics,May,2015,Q2,May 2015,-11818443820,1382974247,13201418067
Computer & Electronics,June,2015,Q2,June 2015,-12935871287,1444833437,14380704724
Computer & Electronics,July,2015,Q3,July 2015,-11551820511,1641989488,13193809999
Computer & Electronics,August,2015,Q3,August 2015,-12516910407,1491535549,14008445956
Computer & Electronics,September,2015,Q3,September 2015,-14986944847,1490574870,16477519717
Computer & Electronics,October,2015,Q4,October 2015,-15535474233,1515042111,17050516344
Computer & Electronics,November,2015,Q4,November 2015,-16315976827,1368301759,17684278586
Computer & Electronics,December,2015,Q4,December 2015,-12651901044,1681563791,14333464835
Computer & Electronics,January,2016,Q1,January 2016,-10395963788,1300037752,11696001540
Computer & Electronics,February,2016,Q1,February 2016,-9361720250,1143287332,10505007582
Computer & Electronics,March,2016,Q1,March 2016,-9962412699,1627714962,11590127661
Computer & Electronics,April,2016,Q2,April 2016,-9623395348,1322386935,10945782283
Computer & Electronics,May,2016,Q2,May 2016,-11191426863,1491281951,12682708814
Computer & Electronics,June,2016,Q2,June 2016,-11969906578,1412043980,13381950558
Computer & Electronics,July,2016,Q3,July 2016,-11717658261,1380190828,13097849089
Computer & Electronics,August,2016,Q3,August 2016,-12426737677,1509049614,13935787291
Computer & Electronics,September,2016,Q3,September 2016,-13642256321,1429126812,15071383133
Computer & Electronics,October,2016,Q4,October 2016,-14766172703,1504348755,16270521458
Computer & Electronics,November,2016,Q4,November 2016,-16080492769,1375422694,17455915463
Computer & Electronics,December,2016,Q4,December 2016,-12987439010,1612723396,14600162406
Computer & Electronics,January,2017,Q1,January 2017,-12329891382,1165220330,13495111712
Computer & Electronics,February,2017,Q1,February 2017,-8706755590,1299183421,10005939011
Computer & Electronics,March,2017,Q1,March 2017,-11725766737,1419900627,13145667364
Computer & Electronics,April,2017,Q2,April 2017,-12025756573,1373978940,13399735513
Computer & Electronics,May,2017,Q2,May 2017,-13157366329,1352838174,14510204503
Computer & Electronics,June,2017,Q2,June 2017,-13353931715,1539442725,14893374440
Computer & Electronics,July,2017,Q3,July 2017,-13755214289,1356922147,15112136436
Computer & Electronics,August,2017,Q3,August 2017,-14293517976,1524313791,15817831767
Computer & Electronics,September,2017,Q3,September 2017,-15138906145,1489724282,16628630427
Computer & Electronics,October,2017,Q4,October 2017,-16596946562,1546284429,18143230991
Computer & Electronics,November,2017,Q4,November 2017,-19172805997,1672437699,20845243696
Computer & Electronics,December,2017,Q4,December 2017,-16496880391,1559965289,18056845680
Computer & Electronics,January,2018,Q1,January 2018,-14184806261,1442813234,15627619495
Computer & Electronics,February,2018,Q1,February 2018,-10897495125,1120180585,12017675710
Computer & Electronics,March,2018,Q1,March 2018,-12860524529,1615234930,14475759459
Computer & Electronics,April,2018,Q2,April 2018,-12611827419,1404775857,14016603276
Computer & Electronics,May,2018,Q2,May 2018,-13749614296,1415543359,15165157655
Computer & Electronics,June,2018,Q2,June 2018,-13309677614,1555374852,14865052466
Computer & Electronics,July,2018,Q3,July 2018,-14210199345,1444734222,15654933567
Computer & Electronics,August,2018,Q3,August 2018,-14074663694,1678770505,15753434199
Computer & Electronics,September,2018,Q3,September 2018,-16551298903,1467284776,18018583679
Computer & Electronics,October,2018,Q4,October 2018,-16688154776,1660807567,18348962343
Computer & Electronics,November,2018,Q4,November 2018,-15602939480,1584092981,17187032461
Computer & Electronics,December,2018,Q4,December 2018,-13034302906,1761727704,14796030610
Computer & Electronics,January,2019,Q1,January 2019,-10590637750,1421602576,12012240326
Computer & Electronics,February,2019,Q1,February 2019,-7505220581,1441732460,8946953041
Computer & Electronics,March,2019,Q1,March 2019,-9026052407,1797438147,10823490554
Computer & Electronics,April,2019,Q2,April 2019,-9473426282,1531182005,11004608287
Computer & Electronics,May,2019,Q2,May 2019,-10969230310,1628241508,12597471818
Computer & Electronics,June,2019,Q2,June 2019,-11943867420,1519609097,13463476517
Computer & Electronics,July,2019,Q3,July 2019,-10745570718,1364157311,12109728029
Computer & Electronics,August,2019,Q3,August 2019,-10092705301,1623202110,11715907411
Computer & Electronics,September,2019,Q3,September 2019,-11570645536,1550015853,13120661389
Computer & Electronics,October,2019,Q4,October 2019,-13137281385,1662158526,14799439911
Computer & Electronics,November,2019,Q4,November 2019,-12487742666,1701330726,14189073392
Computer & Electronics,December,2019,Q4,December 2019,-9842461394,1695183994,11537645388
"Electrical Equipment, Appliances & Components",January,2002,Q1,January 2002,-624500660,36199602,660700262
"Electrical Equipment, Appliances & Components",February,2002,Q1,February 2002,-595760843,48462112,644222955
"Electrical Equipment, Appliances & Components",March,2002,Q1,March 2002,-554801816,45328204,600130020
"Electrical Equipment, Appliances & Components",April,2002,Q2,April 2002,-750054569,48286758,798341327
"Electrical Equipment, Appliances & Components",May,2002,Q2,May 2002,-841454648,57278136,898732784
"Electrical Equipment, Appliances & Components",June,2002,Q2,June 2002,-822784978,40134979,862919957
"Electrical Equipment, Appliances & Components",July,2002,Q3,July 2002,-871845671,44628423,916474094
"Electrical Equipment, Appliances & Components",August,2002,Q3,August 2002,-1026637943,48394010,1075031953
"Electrical Equipment, Appliances & Components",September,2002,Q3,September 2002,-1058320455,39145761,1097466216
"Electrical Equipment, Appliances & Components",October,2002,Q4,October 2002,-1003220487,43258599,1046479086
"Electrical Equipment, Appliances & Components",November,2002,Q4,November 2002,-1000084600,58948413,1059033013
"Electrical Equipment, Appliances & Components",December,2002,Q4,December 2002,-852596693,35386052,887982745
"Electrical Equipment, Appliances & Components",January,2003,Q1,January 2003,-817841412,35338937,853180349
"Electrical Equipment, Appliances & Components",February,2003,Q1,February 2003,-723785535,39840593,763626128
"Electrical Equipment, Appliances & Components",March,2003,Q1,March 2003,-750393401,53105160,803498561
"Electrical Equipment, Appliances & Components",April,2003,Q2,April 2003,-931535360,45867703,977403063
"Electrical Equipment, Appliances & Components",May,2003,Q2,May 2003,-971810460,42667454,1014477914
"Electrical Equipment, Appliances & Components",June,2003,Q2,June 2003,-872627851,38912554,911540405
"Electrical Equipment, Appliances & Components",July,2003,Q3,July 2003,-922307709,41720707,964028416
"Electrical Equipment, Appliances & Components",August,2003,Q3,August 2003,-1015542382,47466987,1063009369
"Electrical Equipment, Appliances & Components",September,2003,Q3,September 2003,-1157459793,41120187,1198579980
"Electrical Equipment, Appliances & Components",October,2003,Q4,October 2003,-1288876334,51195707,1340072041
"Electrical Equipment, Appliances & Components",November,2003,Q4,November 2003,-1021875273,54663244,1076538517
"Electrical Equipment, Appliances & Components",December,2003,Q4,December 2003,-878525255,60017609,938542864
"Electrical Equipment, Appliances & Components",January,2004,Q1,January 2004,-1002697153,52836626,1055533779
"Electrical Equipment, Appliances & Components",February,2004,Q1,February 2004,-777382804,65025808,842408612
"Electrical Equipment, Appliances & Components",March,2004,Q1,March 2004,-1037688723,71940881,1109629604
"Electrical Equipment, Appliances & Components",April,2004,Q2,April 2004,-1139971786,69040694,1209012480
"Electrical Equipment, Appliances & Components",May,2004,Q2,May 2004,-1150357295,74146142,1224503437
"Electrical Equipment, Appliances & Components",June,2004,Q2,June 2004,-1159951635,66452017,1226403652
"Electrical Equipment, Appliances & Components",July,2004,Q3,July 2004,-1177332667,66149426,1243482093
"Electrical Equipment, Appliances & Components",August,2004,Q3,August 2004,-1304349471,59661978,1364011449
"Electrical Equipment, Appliances & Components",September,2004,Q3,September 2004,-1329213569,82406031,1411619600
"Electrical Equipment, Appliances & Components",October,2004,Q4,October 2004,-1474035409,69021044,1543056453
"Electrical Equipment, Appliances & Components",November,2004,Q4,November 2004,-1348894051,74810601,1423704652
"Electrical Equipment, Appliances & Components",December,2004,Q4,December 2004,-1088463099,85978160,1174441259
"Electrical Equipment, Appliances & Components",January,2005,Q1,January 2005,-1177600758,67384846,1244985604
"Electrical Equipment, Appliances & Components",February,2005,Q1,February 2005,-1166683984,59337076,1226021060
"Electrical Equipment, Appliances & Components",March,2005,Q1,March 2005,-1067057235,81118295,1148175530
"Electrical Equipment, Appliances & Components",April,2005,Q2,April 2005,-1250994123,79075135,1330069258
"Electrical Equipment, Appliances & Components",May,2005,Q2,May 2005,-1281470802,106130662,1387601464
"Electrical Equipment, Appliances & Components",June,2005,Q2,June 2005,-1323167951,91547118,1414715069
"Electrical Equipment, Appliances & Components",July,2005,Q3,July 2005,-1352533056,84343153,1436876209
"Electrical Equipment, Appliances & Components",August,2005,Q3,August 2005,-1589470735,88622722,1678093457
"Electrical Equipment, Appliances & Components",September,2005,Q3,September 2005,-1654453657,74915103,1729368760
"Electrical Equipment, Appliances & Components",October,2005,Q4,October 2005,-1755812774,82515676,1838328450
"Electrical Equipment, Appliances & Components",November,2005,Q4,November 2005,-1462105182,86325851,1548431033
"Electrical Equipment, Appliances & Components",December,2005,Q4,December 2005,-1265536013,97228920,1362764933
"Electrical Equipment, Appliances & Components",January,2006,Q1,January 2006,-1451923712,75957847,1527881559
"Electrical Equipment, Appliances & Components",February,2006,Q1,February 2006,-1205030366,87869807,1292900173
"Electrical Equipment, Appliances & Components",March,2006,Q1,March 2006,-1376798511,103716231,1480514742
"Electrical Equipment, Appliances & Components",April,2006,Q2,April 2006,-1521471330,98324436,1619795766
"Electrical Equipment, Appliances & Components",May,2006,Q2,May 2006,-1584423911,119595429,1704019340
"Electrical Equipment, Appliances & Components",June,2006,Q2,June 2006,-1535548174,126970914,1662519088
"Electrical Equipment, Appliances & Components",July,2006,Q3,July 2006,-1526249376,118424853,1644674229
"Electrical Equipment, Appliances & Components",August,2006,Q3,August 2006,-1848380243,125432424,1973812667
"Electrical Equipment, Appliances & Components",September,2006,Q3,September 2006,-1913286293,112700872,2025987165
"Electrical Equipment, Appliances & Components",October,2006,Q4,October 2006,-1979267034,112889183,2092156217
"Electrical Equipment, Appliances & Components",November,2006,Q4,November 2006,-1691209714,96810049,1788019763
"Electrical Equipment, Appliances & Components",December,2006,Q4,December 2006,-1340677768,147837294,1488515062
"Electrical Equipment, Appliances & Components",January,2007,Q1,January 2007,-1568848973,87309472,1656158445
"Electrical Equipment, Appliances & Components",February,2007,Q1,February 2007,-1539122880,101281443,1640404323
"Electrical Equipment, Appliances & Components",March,2007,Q1,March 2007,-1395677352,114055539,1509732891
"Electrical Equipment, Appliances & Components",April,2007,Q2,April 2007,-1667167069,104159728,1771326797
"Electrical Equipment, Appliances & Components",May,2007,Q2,May 2007,-1735353636,112931897,1848285533
"Electrical Equipment, Appliances & Components",June,2007,Q2,June 2007,-1683218831,115543003,1798761834
"Electrical Equipment, Appliances & Components",July,2007,Q3,July 2007,-1762850488,101963522,1864814010
"Electrical Equipment, Appliances & Components",August,2007,Q3,August 2007,-1944849173,127932978,2072782151
"Electrical Equipment, Appliances & Components",September,2007,Q3,September 2007,-2038330127,116149269,2154479396
"Electrical Equipment, Appliances & Components",October,2007,Q4,October 2007,-2155008668,127179411,2282188079
"Electrical Equipment, Appliances & Components",November,2007,Q4,November 2007,-1845731886,159895426,2005627312
"Electrical Equipment, Appliances & Components",December,2007,Q4,December 2007,-1493568237,131134452,1624702689
"Electrical Equipment, Appliances & Components",January,2008,Q1,January 2008,-1611953300,118208545,1730161845
"Electrical Equipment, Appliances & Components",February,2008,Q1,February 2008,-1551080762,144233842,1695314604
"Electrical Equipment, Appliances & Components",March,2008,Q1,March 2008,-1351523238,159812287,1511335525
"Electrical Equipment, Appliances & Components",April,2008,Q2,April 2008,-1699803765,169740456,1869544221
"Electrical Equipment, Appliances & Components",May,2008,Q2,May 2008,-1768488222,162130619,1930618841
"Electrical Equipment, Appliances & Components",June,2008,Q2,June 2008,-1682638171,141665520,1824303691
"Electrical Equipment, Appliances & Components",July,2008,Q3,July 2008,-1876895738,143189555,2020085293
"Electrical Equipment, Appliances & Components",August,2008,Q3,August 2008,-2067365436,171080027,2238445463
"Electrical Equipment, Appliances & Components",September,2008,Q3,September 2008,-2244212613,132658718,2376871331
"Electrical Equipment, Appliances & Components",October,2008,Q4,October 2008,-2326543233,182241102,2508784335
"Electrical Equipment, Appliances & Components",November,2008,Q4,November 2008,-1833830819,139018286,1972849105
"Electrical Equipment, Appliances & Components",December,2008,Q4,December 2008,-1527572765,130181927,1657754692
"Electrical Equipment, Appliances & Components",January,2009,Q1,January 2009,-1575650799,84114658,1659765457
"Electrical Equipment, Appliances & Components",February,2009,Q1,February 2009,-1147940860,80703611,1228644471
"Electrical Equipment, Appliances & Components",March,2009,Q1,March 2009,-1371584452,122994804,1494579256
"Electrical Equipment, Appliances & Components",April,2009,Q2,April 2009,-1517510648,100557727,1618068375
"Electrical Equipment, Appliances & Components",May,2009,Q2,May 2009,-1555858872,122218869,1678077741
"Electrical Equipment, Appliances & Components",June,2009,Q2,June 2009,-1440962792,124971010,1565933802
"Electrical Equipment, Appliances & Components",July,2009,Q3,July 2009,-1512382025,95864273,1608246298
"Electrical Equipment, Appliances & Components",August,2009,Q3,August 2009,-1733081156,101841354,1834922510
"Electrical Equipment, Appliances & Components",September,2009,Q3,September 2009,-1859248713,114364164,1973612877
"Electrical Equipment, Appliances & Components",October,2009,Q4,October 2009,-1921496748,113917660,2035414408
"Electrical Equipment, Appliances & Components",November,2009,Q4,November 2009,-1656543672,136869107,1793412779
"Electrical Equipment, Appliances & Components",December,2009,Q4,December 2009,-1510601826,143950169,1654551995
"Electrical Equipment, Appliances & Components",January,2010,Q1,January 2010,-1553774668,109358581,1663133249
"Electrical Equipment, Appliances & Components",February,2010,Q1,February 2010,-1515008769,129104422,1644113191
"Electrical Equipment, Appliances & Components",March,2010,Q1,March 2010,-1523181976,161676201,1684858177
"Electrical Equipment, Appliances & Components",April,2010,Q2,April 2010,-1759310549,149426497,1908737046
"Electrical Equipment, Appliances & Components",May,2010,Q2,May 2010,-1937505884,146546381,2084052265
"Electrical Equipment, Appliances & Components",June,2010,Q2,June 2010,-2077643328,137154750,2214798078
"Electrical Equipment, Appliances & Components",July,2010,Q3,July 2010,-2127432064,130451618,2257883682
"Electrical Equipment, Appliances & Components",August,2010,Q3,August 2010,-2450101522,141573571,2591675093
"Electrical Equipment, Appliances & Components",September,2010,Q3,September 2010,-2629668886,129121331,2758790217
"Electrical Equipment, Appliances & Components",October,2010,Q4,October 2010,-2543115726,132441619,2675557345
"Electrical Equipment, Appliances & Components",November,2010,Q4,November 2010,-2293886952,124925246,2418812198
"Electrical Equipment, Appliances & Components",December,2010,Q4,December 2010,-2006599435,154469171,2161068606
"Electrical Equipment, Appliances & Components",January,2011,Q1,January 2011,-2079143591,129228502,2208372093
"Electrical Equipment, Appliances & Components",February,2011,Q1,February 2011,-1748204713,122309902,1870514615
"Electrical Equipment, Appliances & Components",March,2011,Q1,March 2011,-1729913152,165362311,1895275463
"Electrical Equipment, Appliances & Components",April,2011,Q2,April 2011,-2050317637,161311971,2211629608
"Electrical Equipment, Appliances & Components",May,2011,Q2,May 2011,-2162138888,167755270,2329894158
"Electrical Equipment, Appliances & Components",June,2011,Q2,June 2011,-2204581969,170684958,2375266927
"Electrical Equipment, Appliances & Components",July,2011,Q3,July 2011,-2223663389,160428916,2384092305
"Electrical Equipment, Appliances & Components",August,2011,Q3,August 2011,-2504269156,168972163,2673241319
"Electrical Equipment, Appliances & Components",September,2011,Q3,September 2011,-2639236165,156628297,2795864462
"Electrical Equipment, Appliances & Components",October,2011,Q4,October 2011,-2662259963,158407961,2820667924
"Electrical Equipment, Appliances & Components",November,2011,Q4,November 2011,-2708431065,189135935,2897567000
"Electrical Equipment, Appliances & Components",December,2011,Q4,December 2011,-2202530500,183031171,2385561671
"Electrical Equipment, Appliances & Components",January,2012,Q1,January 2012,-2413551459,138725095,2552276554
"Electrical Equipment, Appliances & Components",February,2012,Q1,February 2012,-1821538700,177743811,1999282511
"Electrical Equipment, Appliances & Components",March,2012,Q1,March 2012,-2052687491,233644872,2286332363
"Electrical Equipment, Appliances & Components",April,2012,Q2,April 2012,-2517486901,205604939,2723091840
"Electrical Equipment, Appliances & Components",May,2012,Q2,May 2012,-2514433962,226051480,2740485442
"Electrical Equipment, Appliances & Components",June,2012,Q2,June 2012,-2505101121,215029230,2720130351
"Electrical Equipment, Appliances & Components",July,2012,Q3,July 2012,-2686976963,218223555,2905200518
"Electrical Equipment, Appliances & Components",August,2012,Q3,August 2012,-2964284963,215621826,3179906789
"Electrical Equipment, Appliances & Components",September,2012,Q3,September 2012,-3047149719,183650887,3230800606
"Electrical Equipment, Appliances & Components",October,2012,Q4,October 2012,-2982558280,199700153,3182258433
"Electrical Equipment, Appliances & Components",November,2012,Q4,November 2012,-2665312538,232449494,2897762032
"Electrical Equipment, Appliances & Components",December,2012,Q4,December 2012,-2659004815,232997430,2892002245
"Electrical Equipment, Appliances & Components",January,2013,Q1,January 2013,-2640350965,240792548,2881143513
"Electrical Equipment, Appliances & Components",February,2013,Q1,February 2013,-2523645057,193139456,2716784513
"Electrical Equipment, Appliances & Components",March,2013,Q1,March 2013,-1884052971,246652022,2130704993
"Electrical Equipment, Appliances & Components",April,2013,Q2,April 2013,-2591137349,234181699,2825319048
"Electrical Equipment, Appliances & Components",May,2013,Q2,May 2013,-2810152915,260714438,3070867353
"Electrical Equipment, Appliances & Components",June,2013,Q2,June 2013,-2722484381,224063343,2946547724
"Electrical Equipment, Appliances & Components",July,2013,Q3,July 2013,-2989009270,209084487,3198093757
"Electrical Equipment, Appliances & Components",August,2013,Q3,August 2013,-3303632801,236611160,3540243961
"Electrical Equipment, Appliances & Components",September,2013,Q3,September 2013,-3459210311,203420144,3662630455
"Electrical Equipment, Appliances & Components",October,2013,Q4,October 2013,-3409435375,229305601,3638740976
"Electrical Equipment, Appliances & Components",November,2013,Q4,November 2013,-2854502409,235857664,3090360073
"Electrical Equipment, Appliances & Components",December,2013,Q4,December 2013,-2690753708,232790821,2923544529
"Electrical Equipment, Appliances & Components",January,2014,Q1,January 2014,-2914814690,190799543,3105614233
"Electrical Equipment, Appliances & Components",February,2014,Q1,February 2014,-2283747770,209968911,2493716681
"Electrical Equipment, Appliances & Components",March,2014,Q1,March 2014,-2339575589,247027932,2586603521
"Electrical Equipment, Appliances & Components",April,2014,Q2,April 2014,-2766277979,243036569,3009314548
"Electrical Equipment, Appliances & Components",May,2014,Q2,May 2014,-2991213528,257966017,3249179545
"Electrical Equipment, Appliances & Components",June,2014,Q2,June 2014,-3057193990,286353156,3343547146
"Electrical Equipment, Appliances & Components",July,2014,Q3,July 2014,-3082836648,307305368,3390142016
"Electrical Equipment, Appliances & Components",August,2014,Q3,August 2014,-3414916492,268224435,3683140927
"Electrical Equipment, Appliances & Components",September,2014,Q3,September 2014,-3669470030,238770716,3908240746
"Electrical Equipment, Appliances & Components",October,2014,Q4,October 2014,-3503023508,278739134,3781762642
"Electrical Equipment, Appliances & Components",November,2014,Q4,November 2014,-2911649847,244623242,3156273089
"Electrical Equipment, Appliances & Components",December,2014,Q4,December 2014,-2959322093,282228297,3241550390
"Electrical Equipment, Appliances & Components",January,2015,Q1,January 2015,-2885377605,235711338,3121088943
"Electrical Equipment, Appliances & Components",February,2015,Q1,February 2015,-2513608321,201202275,2714810596
"Electrical Equipment, Appliances & Components",March,2015,Q1,March 2015,-3282071394,303019661,3585091055
"Electrical Equipment, Appliances & Components",April,2015,Q2,April 2015,-2978435957,266039455,3244475412
"Electrical Equipment, Appliances & Components",May,2015,Q2,May 2015,-3292786751,278670405,3571457156
"Electrical Equipment, Appliances & Components",June,2015,Q2,June 2015,-3347201174,255201928,3602403102
"Electrical Equipment, Appliances & Components",July,2015,Q3,July 2015,-3320629037,279752045,3600381082
"Electrical Equipment, Appliances & Components",August,2015,Q3,August 2015,-3741793779,262725883,4004519662
"Electrical Equipment, Appliances & Components",September,2015,Q3,September 2015,-3846156330,222583904,4068740234
"Electrical Equipment, Appliances & Components",October,2015,Q4,October 2015,-3562835414,233816978,3796652392
"Electrical Equipment, Appliances & Components",November,2015,Q4,November 2015,-3099627828,214371617,3313999445
"Electrical Equipment, Appliances & Components",December,2015,Q4,December 2015,-2825469356,255254944,3080724300
"Electrical Equipment, Appliances & Components",January,2016,Q1,January 2016,-2990847754,232603726,3223451480
"Electrical Equipment, Appliances & Components",February,2016,Q1,February 2016,-3157265800,193010030,3350275830
"Electrical Equipment, Appliances & Components",March,2016,Q1,March 2016,-2229828482,267505784,2497334266
"Electrical Equipment, Appliances & Components",April,2016,Q2,April 2016,-2816921394,255923685,3072845079
"Electrical Equipment, Appliances & Components",May,2016,Q2,May 2016,-3168048702,240968202,3409016904
"Electrical Equipment, Appliances & Components",June,2016,Q2,June 2016,-3098719464,240761814,3339481278
"Electrical Equipment, Appliances & Components",July,2016,Q3,July 2016,-3080748192,243623851,3324372043
"Electrical Equipment, Appliances & Components",August,2016,Q3,August 2016,-3765012148,249820157,4014832305
"Electrical Equipment, Appliances & Components",September,2016,Q3,September 2016,-3407877701,269180585,3677058286
"Electrical Equipment, Appliances & Components",October,2016,Q4,October 2016,-3558689496,263625810,3822315306
"Electrical Equipment, Appliances & Components",November,2016,Q4,November 2016,-3253783183,237580535,3491363718
"Electrical Equipment, Appliances & Components",December,2016,Q4,December 2016,-3064522436,252075216,3316597652
"Electrical Equipment, Appliances & Components",January,2017,Q1,January 2017,-3289429679,278197940,3567627619
"Electrical Equipment, Appliances & Components",February,2017,Q1,February 2017,-2623320010,236615245,2859935255
"Electrical Equipment, Appliances & Components",March,2017,Q1,March 2017,-2638723410,281954359,2920677769
"Electrical Equipment, Appliances & Components",April,2017,Q2,April 2017,-3192755342,260476253,3453231595
"Electrical Equipment, Appliances & Components",May,2017,Q2,May 2017,-3525793527,273468957,3799262484
"Electrical Equipment, Appliances & Components",June,2017,Q2,June 2017,-3397738256,295834244,3693572500
"Electrical Equipment, Appliances & Components",July,2017,Q3,July 2017,-3457758064,268807644,3726565708
"Electrical Equipment, Appliances & Components",August,2017,Q3,August 2017,-3838843232,279583477,4118426709
"Electrical Equipment, Appliances & Components",September,2017,Q3,September 2017,-3781598515,263372651,4044971166
"Electrical Equipment, Appliances & Components",October,2017,Q4,October 2017,-3943861610,272865634,4216727244
"Electrical Equipment, Appliances & Components",November,2017,Q4,November 2017,-3620238732,278488399,3898727131
"Electrical Equipment, Appliances & Components",December,2017,Q4,December 2017,-3417028600,281927969,3698956569
"Electrical Equipment, Appliances & Components",January,2018,Q1,January 2018,-3889922894,242201408,4132124302
"Electrical Equipment, Appliances & Components",February,2018,Q1,February 2018,-3524260872,224370004,3748630876
"Electrical Equipment, Appliances & Components",March,2018,Q1,March 2018,-2945343616,338748771,3284092387
"Electrical Equipment, Appliances & Components",April,2018,Q2,April 2018,-3265499880,288801338,3554301218
"Electrical Equipment, Appliances & Components",May,2018,Q2,May 2018,-3867268178,307392232,4174660410
"Electrical Equipment, Appliances & Components",June,2018,Q2,June 2018,-3836286039,312760975,4149047014
"Electrical Equipment, Appliances & Components",July,2018,Q3,July 2018,-4020809659,298861228,4319670887
"Electrical Equipment, Appliances & Components",August,2018,Q3,August 2018,-4233666398,308039396,4541705794
"Electrical Equipment, Appliances & Components",September,2018,Q3,September 2018,-4333125757,266178168,4599303925
"Electrical Equipment, Appliances & Components",October,2018,Q4,October 2018,-4560044457,262330055,4822374512
"Electrical Equipment, Appliances & Components",November,2018,Q4,November 2018,-3961021849,265639165,4226661014
"Electrical Equipment, Appliances & Components",December,2018,Q4,December 2018,-4267894867,281862485,4549757352
"Electrical Equipment, Appliances & Components",January,2019,Q1,January 2019,-3765897298,224284141,3990181439
"Electrical Equipment, Appliances & Components",February,2019,Q1,February 2019,-3060518931,209806225,3270325156
"Electrical Equipment, Appliances & Components",March,2019,Q1,March 2019,-2548063533,304389972,2852453505
"Electrical Equipment, Appliances & Components",April,2019,Q2,April 2019,-3248471046,234968945,3483439991
"Electrical Equipment, Appliances & Components",May,2019,Q2,May 2019,-3577370360,281212719,3858583079
"Electrical Equipment, Appliances & Components",June,2019,Q2,June 2019,-3236027417,266466226,3502493643
"Electrical Equipment, Appliances & Components",July,2019,Q3,July 2019,-3624343909,224367695,3848711604
"Electrical Equipment, Appliances & Components",August,2019,Q3,August 2019,-3681939436,246766551,3928705987
"Electrical Equipment, Appliances & Components",September,2019,Q3,September 2019,-3535690094,258914438,3794604532
"Electrical Equipment, Appliances & Components",October,2019,Q4,October 2019,-3306204172,297816362,3604020534
"Electrical Equipment, Appliances & Components",November,2019,Q4,November 2019,-3086116464,270267888,3356384352
"Electrical Equipment, Appliances & Components",December,2019,Q4,December 2019,-2875933321,287546574,3163479895
Transportation Equipment,January,2002,Q1,January 2002,133674783,271691177,138016394
Transportation Equipment,February,2002,Q1,February 2002,82594901,250171433,167576532
Transportation Equipment,March,2002,Q1,March 2002,169410219,332551568,163141349
Transportation Equipment,April,2002,Q2,April 2002,-48418836,158244316,206663152
Transportation Equipment,May,2002,Q2,May 2002,46422952,261625384,215202432
Transportation Equipment,June,2002,Q2,June 2002,354398655,567145193,212746538
Transportation Equipment,July,2002,Q3,July 2002,154931157,350930235,195999078
Transportation Equipment,August,2002,Q3,August 2002,42535363,256810160,214274797
Transportation Equipment,September,2002,Q3,September 2002,461936921,643573785,181636864
Transportation Equipment,October,2002,Q4,October 2002,102045769,291210405,189164636
Transportation Equipment,November,2002,Q4,November 2002,128391252,321609215,193217963
Transportation Equipment,December,2002,Q4,December 2002,135711811,320416263,184704452
Transportation Equipment,January,2003,Q1,January 2003,90760807,288973560,198212753
Transportation Equipment,February,2003,Q1,February 2003,-26270901,157466961,183737862
Transportation Equipment,March,2003,Q1,March 2003,75357790,275059944,199702154
Transportation Equipment,April,2003,Q2,April 2003,-92723560,156121102,248844662
Transportation Equipment,May,2003,Q2,May 2003,-45774740,217503201,263277941
Transportation Equipment,June,2003,Q2,June 2003,88829157,349067435,260238278
Transportation Equipment,July,2003,Q3,July 2003,-67493369,203023008,270516377
Transportation Equipment,August,2003,Q3,August 2003,-63012390,182152466,245164856
Transportation Equipment,September,2003,Q3,September 2003,50893112,290099962,239206850
Transportation Equipment,October,2003,Q4,October 2003,85996542,362758405,276761863
Transportation Equipment,November,2003,Q4,November 2003,142766859,399658787,256891928
Transportation Equipment,December,2003,Q4,December 2003,107736781,366958859,259222078
Transportation Equipment,January,2004,Q1,January 2004,-88805905,209108118,297914023
Transportation Equipment,February,2004,Q1,February 2004,29543315,261149763,231606448
Transportation Equipment,March,2004,Q1,March 2004,145484833,450768186,305283353
Transportation Equipment,April,2004,Q2,April 2004,-247232424,112586184,359818608
Transportation Equipment,May,2004,Q2,May 2004,-166885723,201183390,368069113
Transportation Equipment,June,2004,Q2,June 2004,-243334031,162889604,406223635
Transportation Equipment,July,2004,Q3,July 2004,-124028975,266691824,390720799
Transportation Equipment,August,2004,Q3,August 2004,-89774238,256862307,346636545
Transportation Equipment,September,2004,Q3,September 2004,-101764431,235209380,336973811
Transportation Equipment,October,2004,Q4,October 2004,-260277017,91344759,351621776
Transportation Equipment,November,2004,Q4,November 2004,-180821299,200101760,380923059
Transportation Equipment,December,2004,Q4,December 2004,-165529261,196631492,362160753
Transportation Equipment,January,2005,Q1,January 2005,-244602474,132015794,376618268
Transportation Equipment,February,2005,Q1,February 2005,-11253766,359136364,370390130
Transportation Equipment,March,2005,Q1,March 2005,-101161214,270868524,372029738
Transportation Equipment,April,2005,Q2,April 2005,65926588,512337707,446411119
Transportation Equipment,May,2005,Q2,May 2005,-104600353,360404280,465004633
Transportation Equipment,June,2005,Q2,June 2005,2216877,479889258,477672381
Transportation Equipment,July,2005,Q3,July 2005,-45108666,441832146,486940812
Transportation Equipment,August,2005,Q3,August 2005,179664132,623013163,443349031
Transportation Equipment,September,2005,Q3,September 2005,-106055359,302032048,408087407
Transportation Equipment,October,2005,Q4,October 2005,-44252499,402299010,446551509
Transportation Equipment,November,2005,Q4,November 2005,-18099938,450599470,468699408
Transportation Equipment,December,2005,Q4,December 2005,112976792,572487235,459510443
Transportation Equipment,January,2006,Q1,January 2006,-86674171,382128553,468802724
Transportation Equipment,February,2006,Q1,February 2006,-130114006,276763271,406877277
Transportation Equipment,March,2006,Q1,March 2006,25901334,498932786,473031452
Transportation Equipment,April,2006,Q2,April 2006,19021249,572887429,553866180
Transportation Equipment,May,2006,Q2,May 2006,-83334689,498545914,581880603
Transportation Equipment,June,2006,Q2,June 2006,-249183022,361351367,610534389
Transportation Equipment,July,2006,Q3,July 2006,362307685,937164421,574856736
Transportation Equipment,August,2006,Q3,August 2006,-121896402,490940117,612836519
Transportation Equipment,September,2006,Q3,September 2006,95175025,659255728,564080703
Transportation Equipment,October,2006,Q4,October 2006,-85920347,477678719,563599066
Transportation Equipment,November,2006,Q4,November 2006,13953812,586096567,572142755
Transportation Equipment,December,2006,Q4,December 2006,150683545,661293915,510610370
Transportation Equipment,January,2007,Q1,January 2007,-260048841,355330238,615379079
Transportation Equipment,February,2007,Q1,February 2007,-62750936,505876135,568627071
Transportation Equipment,March,2007,Q1,March 2007,37859693,616660234,578800541
Transportation Equipment,April,2007,Q2,April 2007,-236649545,410575739,647225284
Transportation Equipment,May,2007,Q2,May 2007,-177433541,512159690,689593231
Transportation Equipment,June,2007,Q2,June 2007,199414622,905901682,706487060
Transportation Equipment,July,2007,Q3,July 2007,-307149330,437881725,745031055
Transportation Equipment,August,2007,Q3,August 2007,103583769,765441866,661858097
Transportation Equipment,September,2007,Q3,September 2007,114303874,741934002,627630128
Transportation Equipment,October,2007,Q4,October 2007,-119044417,514197383,633241800
Transportation Equipment,November,2007,Q4,November 2007,-29384750,650513745,679898495
Transportation Equipment,December,2007,Q4,December 2007,179353517,794174007,614820490
Transportation Equipment,January,2008,Q1,January 2008,61100978,683897713,622796735
Transportation Equipment,February,2008,Q1,February 2008,-188850587,414426028,603276615
Transportation Equipment,March,2008,Q1,March 2008,-158392343,428863240,587255583
Transportation Equipment,April,2008,Q2,April 2008,-308841413,377412625,686254038
Transportation Equipment,May,2008,Q2,May 2008,26631016,735049640,708418624
Transportation Equipment,June,2008,Q2,June 2008,-128257394,552176893,680434287
Transportation Equipment,July,2008,Q3,July 2008,-255945291,515502541,771447832
Transportation Equipment,August,2008,Q3,August 2008,171963358,947980346,776016988
Transportation Equipment,September,2008,Q3,September 2008,-329928178,364609743,694537921
Transportation Equipment,October,2008,Q4,October 2008,-293267425,353838418,647105843
Transportation Equipment,November,2008,Q4,November 2008,-342423119,262904839,605327958
Transportation Equipment,December,2008,Q4,December 2008,-98686725,438397450,537084175
Transportation Equipment,January,2009,Q1,January 2009,-46936691,502913343,549850034
Transportation Equipment,February,2009,Q1,February 2009,-140089238,227402172,367491410
Transportation Equipment,March,2009,Q1,March 2009,36496818,478157990,441661172
Transportation Equipment,April,2009,Q2,April 2009,65934534,578520519,512585985
Transportation Equipment,May,2009,Q2,May 2009,35913878,578053754,542139876
Transportation Equipment,June,2009,Q2,June 2009,157831678,681935285,524103607
Transportation Equipment,July,2009,Q3,July 2009,8916227,566526137,557609910
Transportation Equipment,August,2009,Q3,August 2009,-27653377,514233280,541886657
Transportation Equipment,September,2009,Q3,September 2009,239648286,799718826,560070540
Transportation Equipment,October,2009,Q4,October 2009,260558343,838049907,577491564
Transportation Equipment,November,2009,Q4,November 2009,105327954,646043235,540715281
Transportation Equipment,December,2009,Q4,December 2009,522664286,1080180534,557516248
Transportation Equipment,January,2010,Q1,January 2010,69585923,667787525,598201602
Transportation Equipment,February,2010,Q1,February 2010,313726416,865921356,552194940
Transportation Equipment,March,2010,Q1,March 2010,324940940,938967148,614026208
Transportation Equipment,April,2010,Q2,April 2010,80971462,732872556,651901094
Transportation Equipment,May,2010,Q2,May 2010,64340233,824059357,759719124
Transportation Equipment,June,2010,Q2,June 2010,53665223,920271709,866606486
Transportation Equipment,July,2010,Q3,July 2010,368440496,1239228849,870788353
Transportation Equipment,August,2010,Q3,August 2010,122695099,989032330,866337231
Transportation Equipment,September,2010,Q3,September 2010,148601964,942046614,793444650
Transportation Equipment,October,2010,Q4,October 2010,64159838,840999029,776839191
Transportation Equipment,November,2010,Q4,November 2010,-72755490,692827799,765583289
Transportation Equipment,December,2010,Q4,December 2010,209730950,964404227,754673277
Transportation Equipment,January,2011,Q1,January 2011,-301835369,561066296,862901665
Transportation Equipment,February,2011,Q1,February 2011,24641510,795590147,770948637
Transportation Equipment,March,2011,Q1,March 2011,361806128,1099017029,737210901
Transportation Equipment,April,2011,Q2,April 2011,-189752598,749688868,939441466
Transportation Equipment,May,2011,Q2,May 2011,169583296,1148146795,978563499
Transportation Equipment,June,2011,Q2,June 2011,155600536,1120107579,964507043
Transportation Equipment,July,2011,Q3,July 2011,618199431,1556529423,938329992
Transportation Equipment,August,2011,Q3,August 2011,402137629,1396819834,994682205
Transportation Equipment,September,2011,Q3,September 2011,125924500,1057793264,931868764
Transportation Equipment,October,2011,Q4,October 2011,70163659,960661971,890498312
Transportation Equipment,November,2011,Q4,November 2011,407815599,1328611776,920796177
Transportation Equipment,December,2011,Q4,December 2011,512227840,1395968496,883740656
Transportation Equipment,January,2012,Q1,January 2012,-146152572,865264319,1011416891
Transportation Equipment,February,2012,Q1,February 2012,196256565,1029275917,833019352
Transportation Equipment,March,2012,Q1,March 2012,574705149,1506385804,931680655
Transportation Equipment,April,2012,Q2,April 2012,121622216,1176390448,1054768232
Transportation Equipment,May,2012,Q2,May 2012,-172979067,984753786,1157732853
Transportation Equipment,June,2012,Q2,June 2012,-177087411,950831512,1127918923
Transportation Equipment,July,2012,Q3,July 2012,143306334,1291882810,1148576476
Transportation Equipment,August,2012,Q3,August 2012,291673793,1337256090,1045582297
Transportation Equipment,September,2012,Q3,September 2012,476888519,1496104918,1019216399
Transportation Equipment,October,2012,Q4,October 2012,304365705,1364812987,1060447282
Transportation Equipment,November,2012,Q4,November 2012,377335662,1330980104,953644442
Transportation Equipment,December,2012,Q4,December 2012,807664757,1757470027,949805270
Transportation Equipment,January,2013,Q1,January 2013,-7071862,1159524892,1166596754
Transportation Equipment,February,2013,Q1,February 2013,266811011,1315818600,1049007589
Transportation Equipment,March,2013,Q1,March 2013,811824216,1652651221,840827005
Transportation Equipment,April,2013,Q2,April 2013,632049343,1761043404,1128994061
Transportation Equipment,May,2013,Q2,May 2013,350546129,1542059300,1191513171
Transportation Equipment,June,2013,Q2,June 2013,1026766724,2165329011,1138562287
Transportation Equipment,July,2013,Q3,July 2013,906980290,2099181532,1192201242
Transportation Equipment,August,2013,Q3,August 2013,815264597,2004927376,1189662779
Transportation Equipment,September,2013,Q3,September 2013,1046092457,2188286723,1142194266
Transportation Equipment,October,2013,Q4,October 2013,1058133976,2176723083,1118589107
Transportation Equipment,November,2013,Q4,November 2013,877368354,1939942146,1062573792
Transportation Equipment,December,2013,Q4,December 2013,1497577437,2555581888,1058004451
Transportation Equipment,January,2014,Q1,January 2014,291426069,1610597115,1319171046
Transportation Equipment,February,2014,Q1,February 2014,552152584,1631464260,1079311676
Transportation Equipment,March,2014,Q1,March 2014,1538486676,2651024128,1112537452
Transportation Equipment,April,2014,Q2,April 2014,767823084,2095655363,1327832279
Transportation Equipment,May,2014,Q2,May 2014,652255283,2103715750,1451460467
Transportation Equipment,June,2014,Q2,June 2014,790369126,2165807130,1375438004
Transportation Equipment,July,2014,Q3,July 2014,899518390,2286324901,1386806511
Transportation Equipment,August,2014,Q3,August 2014,1123103654,2494315950,1371212296
Transportation Equipment,September,2014,Q3,September 2014,901557765,2282450077,1380892312
Transportation Equipment,October,2014,Q4,October 2014,825990949,2181167555,1355176606
Transportation Equipment,November,2014,Q4,November 2014,950346503,2162629301,1212282798
Transportation Equipment,December,2014,Q4,December 2014,1595377466,2806912098,1211534632
Transportation Equipment,January,2015,Q1,January 2015,340538027,1808950100,1468412073
Transportation Equipment,February,2015,Q1,February 2015,518026602,1741810650,1223784048
Transportation Equipment,March,2015,Q1,March 2015,308275983,1956589311,1648313328
Transportation Equipment,April,2015,Q2,April 2015,591787111,2159330670,1567543559
Transportation Equipment,May,2015,Q2,May 2015,213032226,1823259474,1610227248
Transportation Equipment,June,2015,Q2,June 2015,1311947824,2877695963,1565748139
Transportation Equipment,July,2015,Q3,July 2015,734729337,2279606860,1544877523
Transportation Equipment,August,2015,Q3,August 2015,779545089,2324959336,1545414247
Transportation Equipment,September,2015,Q3,September 2015,1095650071,2524533309,1428883238
Transportation Equipment,October,2015,Q4,October 2015,741076851,2114355069,1373278218
Transportation Equipment,November,2015,Q4,November 2015,741412110,2131746531,1390334421
Transportation Equipment,December,2015,Q4,December 2015,881824718,2294867179,1413042461
Transportation Equipment,January,2016,Q1,January 2016,-251856878,1244911808,1496768686
Transportation Equipment,February,2016,Q1,February 2016,-150683347,1311582059,1462265406
Transportation Equipment,March,2016,Q1,March 2016,463445911,1692213735,1228767824
Transportation Equipment,April,2016,Q2,April 2016,847719691,2282734955,1435015264
Transportation Equipment,May,2016,Q2,May 2016,737486151,2325373477,1587887326
Transportation Equipment,June,2016,Q2,June 2016,1222912333,2770365966,1547453633
Transportation Equipment,July,2016,Q3,July 2016,861609272,2409209243,1547599971
Transportation Equipment,August,2016,Q3,August 2016,721756962,2331496188,1609739226
Transportation Equipment,September,2016,Q3,September 2016,1025923500,2540676310,1514752810
Transportation Equipment,October,2016,Q4,October 2016,828554772,2346019351,1517464579
Transportation Equipment,November,2016,Q4,November 2016,788647571,2221837600,1433190029
Transportation Equipment,December,2016,Q4,December 2016,444255549,2082123819,1637868270
Transportation Equipment,January,2017,Q1,January 2017,26120517,1676658721,1650538204
Transportation Equipment,February,2017,Q1,February 2017,244674386,1707146485,1462472099
Transportation Equipment,March,2017,Q1,March 2017,333713611,1727125398,1393411787
Transportation Equipment,April,2017,Q2,April 2017,863089681,2352973794,1489884113
Transportation Equipment,May,2017,Q2,May 2017,662210220,2369748296,1707538076
Transportation Equipment,June,2017,Q2,June 2017,765987658,2490937755,1724950097
Transportation Equipment,July,2017,Q3,July 2017,1289294210,2941064956,1651770746
Transportation Equipment,August,2017,Q3,August 2017,1620504411,3219370745,1598866334
Transportation Equipment,September,2017,Q3,September 2017,1016523322,2513025986,1496502664
Transportation Equipment,October,2017,Q4,October 2017,441279261,2065662693,1624383432
Transportation Equipment,November,2017,Q4,November 2017,949414336,2560672410,1611258074
Transportation Equipment,December,2017,Q4,December 2017,1971752293,3568986616,1597234323
Transportation Equipment,January,2018,Q1,January 2018,-400344096,1353152416,1753496512
Transportation Equipment,February,2018,Q1,February 2018,243723686,1806120743,1562397057
Transportation Equipment,March,2018,Q1,March 2018,1242278749,2894271164,1651992415
Transportation Equipment,April,2018,Q2,April 2018,301008647,2011473968,1710465321
Transportation Equipment,May,2018,Q2,May 2018,216311076,2214598051,1998286975
Transportation Equipment,June,2018,Q2,June 2018,278668007,2212599686,1933931679
Transportation Equipment,July,2018,Q3,July 2018,332180114,2218472985,1886292871
Transportation Equipment,August,2018,Q3,August 2018,210434580,2182618458,1972183878
Transportation Equipment,September,2018,Q3,September 2018,1757373881,3593008124,1835634243
Transportation Equipment,October,2018,Q4,October 2018,432863261,2356180171,1923316910
Transportation Equipment,November,2018,Q4,November 2018,544083854,2355786715,1811702861
Transportation Equipment,December,2018,Q4,December 2018,629110916,2645985014,2016874098
Transportation Equipment,January,2019,Q1,January 2019,-655085818,1062721993,1717807811
Transportation Equipment,February,2019,Q1,February 2019,328600942,1850345940,1521744998
Transportation Equipment,March,2019,Q1,March 2019,1281143949,2733468143,1452324194
Transportation Equipment,April,2019,Q2,April 2019,-375928995,1255615738,1631544733
Transportation Equipment,May,2019,Q2,May 2019,-314004907,1342334791,1656339698
Transportation Equipment,June,2019,Q2,June 2019,-53313393,1446905469,1500218862
Transportation Equipment,July,2019,Q3,July 2019,207593061,1790488182,1582895121
Transportation Equipment,August,2019,Q3,August 2019,164918272,1705074624,1540156352
Transportation Equipment,September,2019,Q3,September 2019,457542076,1914094545,1456552469
Transportation Equipment,October,2019,Q4,October 2019,50774676,1475139129,1424364453
Transportation Equipment,November,2019,Q4,November 2019,616788541,1954069495,1337280954
Transportation Equipment,December,2019,Q4,December 2019,-38307612,1207970190,1246277802
Furniture & Fixtures,January,2002,Q1,January 2002,-521989309,883336,522872645
Furniture & Fixtures,February,2002,Q1,February 2002,-548005979,1497439,549503418
Furniture & Fixtures,March,2002,Q1,March 2002,-487788482,1698041,489486523
Furniture & Fixtures,April,2002,Q2,April 2002,-594063815,1637033,595700848
Furniture & Fixtures,May,2002,Q2,May 2002,-614052970,1353344,615406314
Furniture & Fixtures,June,2002,Q2,June 2002,-568603260,2179188,570782448
Furniture & Fixtures,July,2002,Q3,July 2002,-562148648,1761510,563910158
Furniture & Fixtures,August,2002,Q3,August 2002,-556733643,2536040,559269683
Furniture & Fixtures,September,2002,Q3,September 2002,-533359696,1544768,534904464
Furniture & Fixtures,October,2002,Q4,October 2002,-464072453,1212074,465284527
Furniture & Fixtures,November,2002,Q4,November 2002,-566010423,2388227,568398650
Furniture & Fixtures,December,2002,Q4,December 2002,-777067042,1909954,778976996
Furniture & Fixtures,January,2003,Q1,January 2003,-768357773,1848714,770206487
Furniture & Fixtures,February,2003,Q1,February 2003,-639957046,2551437,642508483
Furniture & Fixtures,March,2003,Q1,March 2003,-639156978,2758783,641915761
Furniture & Fixtures,April,2003,Q2,April 2003,-783902032,1967958,785869990
Furniture & Fixtures,May,2003,Q2,May 2003,-757767851,2026430,759794281
Furniture & Fixtures,June,2003,Q2,June 2003,-679125219,2125550,681250769
Furniture & Fixtures,July,2003,Q3,July 2003,-658124988,2751221,660876209
Furniture & Fixtures,August,2003,Q3,August 2003,-609896129,2488779,612384908
Furniture & Fixtures,September,2003,Q3,September 2003,-626996442,2493072,629489514
Furniture & Fixtures,October,2003,Q4,October 2003,-716232969,2372714,718605683
Furniture & Fixtures,November,2003,Q4,November 2003,-751486938,2357153,753844091
Furniture & Fixtures,December,2003,Q4,December 2003,-851782323,2027803,853810126
Furniture & Fixtures,January,2004,Q1,January 2004,-895016154,1518920,896535074
Furniture & Fixtures,February,2004,Q1,February 2004,-730561249,1779001,732340250
Furniture & Fixtures,March,2004,Q1,March 2004,-868131447,3171928,871303375
Furniture & Fixtures,April,2004,Q2,April 2004,-958521085,1942510,960463595
Furniture & Fixtures,May,2004,Q2,May 2004,-958110166,2405587,960515753
Furniture & Fixtures,June,2004,Q2,June 2004,-931240244,3080547,934320791
Furniture & Fixtures,July,2004,Q3,July 2004,-802341047,3922239,806263286
Furniture & Fixtures,August,2004,Q3,August 2004,-783133364,2643004,785776368
Furniture & Fixtures,September,2004,Q3,September 2004,-748571501,2925915,751497416
Furniture & Fixtures,October,2004,Q4,October 2004,-816166015,3007268,819173283
Furniture & Fixtures,November,2004,Q4,November 2004,-924492914,3070005,927562919
Furniture & Fixtures,December,2004,Q4,December 2004,-997680683,4171981,1001852664
Furniture & Fixtures,January,2005,Q1,January 2005,-1077762211,2573499,1080335710
Furniture & Fixtures,February,2005,Q1,February 2005,-1029599943,3124279,1032724222
Furniture & Fixtures,March,2005,Q1,March 2005,-890641184,3635932,894277116
Furniture & Fixtures,April,2005,Q2,April 2005,-1101136084,3135997,1104272081
Furniture & Fixtures,May,2005,Q2,May 2005,-1091719500,3492258,1095211758
Furniture & Fixtures,June,2005,Q2,June 2005,-1032312603,4090882,1036403485
Furniture & Fixtures,July,2005,Q3,July 2005,-1016528219,3265083,1019793302
Furniture & Fixtures,August,2005,Q3,August 2005,-1004100097,4383534,1008483631
Furniture & Fixtures,September,2005,Q3,September 2005,-958692410,3097088,961789498
Furniture & Fixtures,October,2005,Q4,October 2005,-1036387178,3870243,1040257421
Furniture & Fixtures,November,2005,Q4,November 2005,-1075740404,3737368,1079477772
Furniture & Fixtures,December,2005,Q4,December 2005,-1195444168,4211051,1199655219
Furniture & Fixtures,January,2006,Q1,January 2006,-1323446990,4233914,1327680904
Furniture & Fixtures,February,2006,Q1,February 2006,-1081571947,2980130,1084552077
Furniture & Fixtures,March,2006,Q1,March 2006,-1112519322,5349292,1117868614
Furniture & Fixtures,April,2006,Q2,April 2006,-1324183520,4898490,1329082010
Furniture & Fixtures,May,2006,Q2,May 2006,-1295137775,3980433,1299118208
Furniture & Fixtures,June,2006,Q2,June 2006,-1203875477,11985366,1215860843
Furniture & Fixtures,July,2006,Q3,July 2006,-1124017302,7275063,1131292365
Furniture & Fixtures,August,2006,Q3,August 2006,-1127909339,5761210,1133670549
Furniture & Fixtures,September,2006,Q3,September 2006,-1064971635,9658141,1074629776
Furniture & Fixtures,October,2006,Q4,October 2006,-1170779425,7844929,1178624354
Furniture & Fixtures,November,2006,Q4,November 2006,-1202974485,7146942,1210121427
Furniture & Fixtures,December,2006,Q4,December 2006,-1303565136,5498839,1309063975
Furniture & Fixtures,January,2007,Q1,January 2007,-1421107273,5067920,1426175193
Furniture & Fixtures,February,2007,Q1,February 2007,-1374865978,6262455,1381128433
Furniture & Fixtures,March,2007,Q1,March 2007,-1138173957,9128429,1147302386
Furniture & Fixtures,April,2007,Q2,April 2007,-1275418909,6008973,1281427882
Furniture & Fixtures,May,2007,Q2,May 2007,-1324100831,14298697,1338399528
Furniture & Fixtures,June,2007,Q2,June 2007,-1268098836,7495727,1275594563
Furniture & Fixtures,July,2007,Q3,July 2007,-1267921214,7159605,1275080819
Furniture & Fixtures,August,2007,Q3,August 2007,-1169101476,9672701,1178774177
Furniture & Fixtures,September,2007,Q3,September 2007,-1136599741,6761211,1143360952
Furniture & Fixtures,October,2007,Q4,October 2007,-1191928618,9684548,1201613166
Furniture & Fixtures,November,2007,Q4,November 2007,-1263451960,6616392,1270068352
Furniture & Fixtures,December,2007,Q4,December 2007,-1318091415,8466069,1326557484
Furniture & Fixtures,January,2008,Q1,January 2008,-1373930360,7685849,1381616209
Furniture & Fixtures,February,2008,Q1,February 2008,-1312658645,8897533,1321556178
Furniture & Fixtures,March,2008,Q1,March 2008,-1043736432,8044564,1051780996
Furniture & Fixtures,April,2008,Q2,April 2008,-1289788322,11124294,1300912616
Furniture & Fixtures,May,2008,Q2,May 2008,-1365908206,13162372,1379070578
Furniture & Fixtures,June,2008,Q2,June 2008,-1201195617,8417729,1209613346
Furniture & Fixtures,July,2008,Q3,July 2008,-1257406592,9113717,1266520309
Furniture & Fixtures,August,2008,Q3,August 2008,-1178986833,7137955,1186124788
Furniture & Fixtures,September,2008,Q3,September 2008,-1164885671,7432327,1172317998
Furniture & Fixtures,October,2008,Q4,October 2008,-1154175591,6794055,1160969646
Furniture & Fixtures,November,2008,Q4,November 2008,-1098445686,6167135,1104612821
Furniture & Fixtures,December,2008,Q4,December 2008,-1141625590,7868307,1149493897
Furniture & Fixtures,January,2009,Q1,January 2009,-1319017180,5102385,1324119565
Furniture & Fixtures,February,2009,Q1,February 2009,-903856939,5106533,908963472
Furniture & Fixtures,March,2009,Q1,March 2009,-963144034,5457061,968601095
Furniture & Fixtures,April,2009,Q2,April 2009,-1108340618,4931708,1113272326
Furniture & Fixtures,May,2009,Q2,May 2009,-1079823287,5935219,1085758506
Furniture & Fixtures,June,2009,Q2,June 2009,-985670402,5396972,991067374
Furniture & Fixtures,July,2009,Q3,July 2009,-1016749332,6039849,1022789181
Furniture & Fixtures,August,2009,Q3,August 2009,-941363957,5954922,947318879
Furniture & Fixtures,September,2009,Q3,September 2009,-915551686,5222979,920774665
Furniture & Fixtures,October,2009,Q4,October 2009,-982935120,6028531,988963651
Furniture & Fixtures,November,2009,Q4,November 2009,-974635965,7014474,981650439
Furniture & Fixtures,December,2009,Q4,December 2009,-1155394003,8194998,1163589001
Furniture & Fixtures,January,2010,Q1,January 2010,-1233692100,6593611,1240285711
Furniture & Fixtures,February,2010,Q1,February 2010,-1066007735,7077813,1073085548
Furniture & Fixtures,March,2010,Q1,March 2010,-1117881566,10105944,1127987510
Furniture & Fixtures,April,2010,Q2,April 2010,-1238496801,8283223,1246780024
Furniture & Fixtures,May,2010,Q2,May 2010,-1392782702,9881585,1402664287
Furniture & Fixtures,June,2010,Q2,June 2010,-1473730706,11472904,1485203610
Furniture & Fixtures,July,2010,Q3,July 2010,-1430996419,9738731,1440735150
Furniture & Fixtures,August,2010,Q3,August 2010,-1349588168,10236305,1359824473
Furniture & Fixtures,September,2010,Q3,September 2010,-1194190563,10871183,1205061746
Furniture & Fixtures,October,2010,Q4,October 2010,-1135015892,11429512,1146445404
Furniture & Fixtures,November,2010,Q4,November 2010,-1153395854,9706559,1163102413
Furniture & Fixtures,December,2010,Q4,December 2010,-1225354828,10968611,1236323439
Furniture & Fixtures,January,2011,Q1,January 2011,-1410396711,8620828,1419017539
Furniture & Fixtures,February,2011,Q1,February 2011,-1261655153,10187391,1271842544
Furniture & Fixtures,March,2011,Q1,March 2011,-1023134838,10429272,1033564110
Furniture & Fixtures,April,2011,Q2,April 2011,-1293937967,13290279,1307228246
Furniture & Fixtures,May,2011,Q2,May 2011,-1392507693,10486591,1402994284
Furniture & Fixtures,June,2011,Q2,June 2011,-1348743304,10391175,1359134479
Furniture & Fixtures,July,2011,Q3,July 2011,-1307632607,10479029,1318111636
Furniture & Fixtures,August,2011,Q3,August 2011,-1247687056,8609189,1256296245
Furniture & Fixtures,September,2011,Q3,September 2011,-1135181060,9923814,1145104874
Furniture & Fixtures,October,2011,Q4,October 2011,-1099255982,10615017,1109870999
Furniture & Fixtures,November,2011,Q4,November 2011,-1232475530,8970895,1241446425
Furniture & Fixtures,December,2011,Q4,December 2011,-1349693775,8115788,1357809563
Furniture & Fixtures,January,2012,Q1,January 2012,-1593939150,8543598,1602482748
Furniture & Fixtures,February,2012,Q1,February 2012,-1131997761,9334216,1141331977
Furniture & Fixtures,March,2012,Q1,March 2012,-1228678497,10540333,1239218830
Furniture & Fixtures,April,2012,Q2,April 2012,-1481073182,12727452,1493800634
Furniture & Fixtures,May,2012,Q2,May 2012,-1516523423,12706403,1529229826
Furniture & Fixtures,June,2012,Q2,June 2012,-1454858531,15642666,1470501197
Furniture & Fixtures,July,2012,Q3,July 2012,-1452527597,13376021,1465903618
Furniture & Fixtures,August,2012,Q3,August 2012,-1263670506,12793851,1276464357
Furniture & Fixtures,September,2012,Q3,September 2012,-1209174910,14391057,1223565967
Furniture & Fixtures,October,2012,Q4,October 2012,-1242063513,13522665,1255586178
Furniture & Fixtures,November,2012,Q4,November 2012,-1249465226,14912077,1264377303
Furniture & Fixtures,December,2012,Q4,December 2012,-1449588239,13495538,1463083777
Furniture & Fixtures,January,2013,Q1,January 2013,-1642354464,7813093,1650167557
Furniture & Fixtures,February,2013,Q1,February 2013,-1566354946,10610619,1576965565
Furniture & Fixtures,March,2013,Q1,March 2013,-1059071517,9599034,1068670551
Furniture & Fixtures,April,2013,Q2,April 2013,-1436103115,12855353,1448958468
Furniture & Fixtures,May,2013,Q2,May 2013,-1502375263,15486998,1517862261
Furniture & Fixtures,June,2013,Q2,June 2013,-1490203338,15317477,1505520815
Furniture & Fixtures,July,2013,Q3,July 2013,-1532756077,13698941,1546455018
Furniture & Fixtures,August,2013,Q3,August 2013,-1384926472,14845360,1399771832
Furniture & Fixtures,September,2013,Q3,September 2013,-1338283211,16271229,1354554440
Furniture & Fixtures,October,2013,Q4,October 2013,-1359054683,15239814,1374294497
Furniture & Fixtures,November,2013,Q4,November 2013,-1401402583,15961550,1417364133
Furniture & Fixtures,December,2013,Q4,December 2013,-1571297664,19619002,1590916666
Furniture & Fixtures,January,2014,Q1,January 2014,-1819708483,20939821,1840648304
Furniture & Fixtures,February,2014,Q1,February 2014,-1416755091,15470681,1432225772
Furniture & Fixtures,March,2014,Q1,March 2014,-1249411005,22271994,1271682999
Furniture & Fixtures,April,2014,Q2,April 2014,-1573745125,16998391,1590743516
Furniture & Fixtures,May,2014,Q2,May 2014,-1616655139,19430362,1636085501
Furniture & Fixtures,June,2014,Q2,June 2014,-1622330782,21574033,1643904815
Furniture & Fixtures,July,2014,Q3,July 2014,-1554398418,17399581,1571797999
Furniture & Fixtures,August,2014,Q3,August 2014,-1409233266,16097648,1425330914
Furniture & Fixtures,September,2014,Q3,September 2014,-1440810521,15207523,1456018044
Furniture & Fixtures,October,2014,Q4,October 2014,-1462091103,17625855,1479716958
Furniture & Fixtures,November,2014,Q4,November 2014,-1433210127,16406376,1449616503
Furniture & Fixtures,December,2014,Q4,December 2014,-1663128608,17237608,1680366216
Furniture & Fixtures,January,2015,Q1,January 2015,-1755772575,15192733,1770965308
Furniture & Fixtures,February,2015,Q1,February 2015,-1418986730,15988706,1434975436
Furniture & Fixtures,March,2015,Q1,March 2015,-1919231962,21257034,1940488996
Furniture & Fixtures,April,2015,Q2,April 2015,-1615011321,13870739,1628882060
Furniture & Fixtures,May,2015,Q2,May 2015,-1849101927,13852966,1862954893
Furniture & Fixtures,June,2015,Q2,June 2015,-1759217882,17405171,1776623053
Furniture & Fixtures,July,2015,Q3,July 2015,-1677978443,17149071,1695127514
Furniture & Fixtures,August,2015,Q3,August 2015,-1622718794,17201167,1639919961
Furniture & Fixtures,September,2015,Q3,September 2015,-1588523690,17483056,1606006746
Furniture & Fixtures,October,2015,Q4,October 2015,-1571077040,17017463,1588094503
Furniture & Fixtures,November,2015,Q4,November 2015,-1653924647,18082720,1672007367
Furniture & Fixtures,December,2015,Q4,December 2015,-1803174174,16697002,1819871176
Furniture & Fixtures,January,2016,Q1,January 2016,-1922269483,12404792,1934674275
Furniture & Fixtures,February,2016,Q1,February 2016,-1947178543,13947267,1961125810
Furniture & Fixtures,March,2016,Q1,March 2016,-1292374705,14812402,1307187107
Furniture & Fixtures,April,2016,Q2,April 2016,-1677671229,15254586,1692925815
Furniture & Fixtures,May,2016,Q2,May 2016,-1891879924,15340243,1907220167
Furniture & Fixtures,June,2016,Q2,June 2016,-1797826555,12782868,1810609423
Furniture & Fixtures,July,2016,Q3,July 2016,-1747576202,15048355,1762624557
Furniture & Fixtures,August,2016,Q3,August 2016,-1742343422,19259653,1761603075
Furniture & Fixtures,September,2016,Q3,September 2016,-1586331334,16959324,1603290658
Furniture & Fixtures,October,2016,Q4,October 2016,-1633848605,12834213,1646682818
Furniture & Fixtures,November,2016,Q4,November 2016,-1794173965,14017236,1808191201
Furniture & Fixtures,December,2016,Q4,December 2016,-2003135255,13701646,2016836901
Furniture & Fixtures,January,2017,Q1,January 2017,-2238559770,11930716,2250490486
Furniture & Fixtures,February,2017,Q1,February 2017,-1719899395,11751512,1731650907
Furniture & Fixtures,March,2017,Q1,March 2017,-1589232006,15152339,1604384345
Furniture & Fixtures,April,2017,Q2,April 2017,-1973622897,16890405,1990513302
Furniture & Fixtures,May,2017,Q2,May 2017,-2185135654,17116401,2202252055
Furniture & Fixtures,June,2017,Q2,June 2017,-2068987683,18895534,2087883217
Furniture & Fixtures,July,2017,Q3,July 2017,-2015649701,15827747,2031477448
Furniture & Fixtures,August,2017,Q3,August 2017,-1891563429,13819228,1905382657
Furniture & Fixtures,September,2017,Q3,September 2017,-1761379667,15598543,1776978210
Furniture & Fixtures,October,2017,Q4,October 2017,-1865640040,15351356,1880991396
Furniture & Fixtures,November,2017,Q4,November 2017,-1962837192,13116893,1975954085
Furniture & Fixtures,December,2017,Q4,December 2017,-2117363762,13898126,2131261888
Furniture & Fixtures,January,2018,Q1,January 2018,-2292667488,11085586,2303753074
Furniture & Fixtures,February,2018,Q1,February 2018,-2140153625,12571854,2152725479
Furniture & Fixtures,March,2018,Q1,March 2018,-1703469880,17528226,1720998106
Furniture & Fixtures,April,2018,Q2,April 2018,-1833751027,13530477,1847281504
Furniture & Fixtures,May,2018,Q2,May 2018,-2227837519,18122029,2245959548
Furniture & Fixtures,June,2018,Q2,June 2018,-2316109153,23494491,2339603644
Furniture & Fixtures,July,2018,Q3,July 2018,-2220787611,18192115,2238979726
Furniture & Fixtures,August,2018,Q3,August 2018,-1999553532,25180136,2024733668
Furniture & Fixtures,September,2018,Q3,September 2018,-1952128294,19783404,1971911698
Furniture & Fixtures,October,2018,Q4,October 2018,-2065797976,14187513,2079985489
Furniture & Fixtures,November,2018,Q4,November 2018,-2094536042,12167447,2106703489
Furniture & Fixtures,December,2018,Q4,December 2018,-2732927155,14369444,2747296599
Furniture & Fixtures,January,2019,Q1,January 2019,-2124246906,12928628,2137175534
Furniture & Fixtures,February,2019,Q1,February 2019,-1749323557,11093213,1760416770
Furniture & Fixtures,March,2019,Q1,March 2019,-1355284576,12169128,1367453704
Furniture & Fixtures,April,2019,Q2,April 2019,-1677127993,10580395,1687708388
Furniture & Fixtures,May,2019,Q2,May 2019,-1924735353,12919270,1937654623
Furniture & Fixtures,June,2019,Q2,June 2019,-1638107989,9666208,1647774197
Furniture & Fixtures,July,2019,Q3,July 2019,-1690616921,10637663,1701254584
Furniture & Fixtures,August,2019,Q3,August 2019,-1409474123,13008745,1422482868
Furniture & Fixtures,September,2019,Q3,September 2019,-1317697397,9400697,1327098094
Furniture & Fixtures,October,2019,Q4,October 2019,-1276737983,14420464,1291158447
Furniture & Fixtures,November,2019,Q4,November 2019,-1244476319,8397316,1252873635
Furniture & Fixtures,December,2019,Q4,December 2019,-1409196487,9435862,1418632349
Miscellaneous Manufactured Commodities,January,2002,Q1,January 2002,-1251922594,14244677,1266167271
Miscellaneous Manufactured Commodities,February,2002,Q1,February 2002,-1096108793,13357956,1109466749
Miscellaneous Manufactured Commodities,March,2002,Q1,March 2002,-920432472,20461222,940893694
Miscellaneous Manufactured Commodities,April,2002,Q2,April 2002,-1269172310,16761643,1285933953
Miscellaneous Manufactured Commodities,May,2002,Q2,May 2002,-1359975327,18073007,1378048334
Miscellaneous Manufactured Commodities,June,2002,Q2,June 2002,-1556853681,20130863,1576984544
Miscellaneous Manufactured Commodities,July,2002,Q3,July 2002,-1830431657,17612284,1848043941
Miscellaneous Manufactured Commodities,August,2002,Q3,August 2002,-2364670581,20851420,2385522001
Miscellaneous Manufactured Commodities,September,2002,Q3,September 2002,-2389207500,15278489,2404485989
Miscellaneous Manufactured Commodities,October,2002,Q4,October 2002,-2193220021,17873042,2211093063
Miscellaneous Manufactured Commodities,November,2002,Q4,November 2002,-2282378744,21050998,2303429742
Miscellaneous Manufactured Commodities,December,2002,Q4,December 2002,-1707812641,17466098,1725278739
Miscellaneous Manufactured Commodities,January,2003,Q1,January 2003,-1623292862,21909796,1645202658
Miscellaneous Manufactured Commodities,February,2003,Q1,February 2003,-1273168716,20504758,1293673474
Miscellaneous Manufactured Commodities,March,2003,Q1,March 2003,-1282500440,20295006,1302795446
Miscellaneous Manufactured Commodities,April,2003,Q2,April 2003,-1465032580,20107493,1485140073
Miscellaneous Manufactured Commodities,May,2003,Q2,May 2003,-1506049262,23419149,1529468411
Miscellaneous Manufactured Commodities,June,2003,Q2,June 2003,-1541802833,22349766,1564152599
Miscellaneous Manufactured Commodities,July,2003,Q3,July 2003,-2053066123,23844900,2076911023
Miscellaneous Manufactured Commodities,August,2003,Q3,August 2003,-2430246743,21899079,2452145822
Miscellaneous Manufactured Commodities,September,2003,Q3,September 2003,-2744185724,22218324,2766404048
Miscellaneous Manufactured Commodities,October,2003,Q4,October 2003,-2949166407,25230493,2974396900
Miscellaneous Manufactured Commodities,November,2003,Q4,November 2003,-2181751080,24129616,2205880696
Miscellaneous Manufactured Commodities,December,2003,Q4,December 2003,-1611231853,22604956,1633836809
Miscellaneous Manufactured Commodities,January,2004,Q1,January 2004,-1719393945,21771328,1741165273
Miscellaneous Manufactured Commodities,February,2004,Q1,February 2004,-1196950426,29289873,1226240299
Miscellaneous Manufactured Commodities,March,2004,Q1,March 2004,-1460688414,39312248,1500000662
Miscellaneous Manufactured Commodities,April,2004,Q2,April 2004,-1596994975,38417883,1635412858
Miscellaneous Manufactured Commodities,May,2004,Q2,May 2004,-1630117200,33681174,1663798374
Miscellaneous Manufactured Commodities,June,2004,Q2,June 2004,-1729950134,29988911,1759939045
Miscellaneous Manufactured Commodities,July,2004,Q3,July 2004,-2185546406,35675046,2221221452
Miscellaneous Manufactured Commodities,August,2004,Q3,August 2004,-2559412828,28699177,2588112005
Miscellaneous Manufactured Commodities,September,2004,Q3,September 2004,-2829247072,26456945,2855704017
Miscellaneous Manufactured Commodities,October,2004,Q4,October 2004,-3009210403,33739442,3042949845
Miscellaneous Manufactured Commodities,November,2004,Q4,November 2004,-2735434946,26542030,2761976976
Miscellaneous Manufactured Commodities,December,2004,Q4,December 2004,-2049227849,35054479,2084282328
Miscellaneous Manufactured Commodities,January,2005,Q1,January 2005,-2036484914,31883479,2068368393
Miscellaneous Manufactured Commodities,February,2005,Q1,February 2005,-1791614903,31172567,1822787470
Miscellaneous Manufactured Commodities,March,2005,Q1,March 2005,-1515884612,41173649,1557058261
Miscellaneous Manufactured Commodities,April,2005,Q2,April 2005,-1850561003,38826792,1889387795
Miscellaneous Manufactured Commodities,May,2005,Q2,May 2005,-1832627925,35397554,1868025479
Miscellaneous Manufactured Commodities,June,2005,Q2,June 2005,-1937300425,42729738,1980030163
Miscellaneous Manufactured Commodities,July,2005,Q3,July 2005,-2371658607,33811989,2405470596
Miscellaneous Manufactured Commodities,August,2005,Q3,August 2005,-2813827968,38230713,2852058681
Miscellaneous Manufactured Commodities,September,2005,Q3,September 2005,-3404659841,36647184,3441307025
Miscellaneous Manufactured Commodities,October,2005,Q4,October 2005,-3520900622,40983814,3561884436
Miscellaneous Manufactured Commodities,November,2005,Q4,November 2005,-2676165343,36752488,2712917831
Miscellaneous Manufactured Commodities,December,2005,Q4,December 2005,-1962117541,39362483,2001480024
Miscellaneous Manufactured Commodities,January,2006,Q1,January 2006,-1924573570,30064020,1954637590
Miscellaneous Manufactured Commodities,February,2006,Q1,February 2006,-1600468818,36605747,1637074565
Miscellaneous Manufactured Commodities,March,2006,Q1,March 2006,-1655794189,46636118,1702430307
Miscellaneous Manufactured Commodities,April,2006,Q2,April 2006,-1908037239,40313309,1948350548
Miscellaneous Manufactured Commodities,May,2006,Q2,May 2006,-2073973613,45996854,2119970467
Miscellaneous Manufactured Commodities,June,2006,Q2,June 2006,-2107206178,48617915,2155824093
Miscellaneous Manufactured Commodities,July,2006,Q3,July 2006,-2460796468,41584532,2502381000
Miscellaneous Manufactured Commodities,August,2006,Q3,August 2006,-3152712972,44117673,3196830645
Miscellaneous Manufactured Commodities,September,2006,Q3,September 2006,-3343026823,41655739,3384682562
Miscellaneous Manufactured Commodities,October,2006,Q4,October 2006,-3839958782,56114068,3896072850
Miscellaneous Manufactured Commodities,November,2006,Q4,November 2006,-3625567238,42451345,3668018583
Miscellaneous Manufactured Commodities,December,2006,Q4,December 2006,-2834362311,41894624,2876256935
Miscellaneous Manufactured Commodities,January,2007,Q1,January 2007,-2420775444,46487302,2467262746
Miscellaneous Manufactured Commodities,February,2007,Q1,February 2007,-2363004053,42605106,2405609159
Miscellaneous Manufactured Commodities,March,2007,Q1,March 2007,-2331101366,57191817,2388293183
Miscellaneous Manufactured Commodities,April,2007,Q2,April 2007,-2700474377,58683335,2759157712
Miscellaneous Manufactured Commodities,May,2007,Q2,May 2007,-2426147614,65151189,2491298803
Miscellaneous Manufactured Commodities,June,2007,Q2,June 2007,-2600843208,59016493,2659859701
Miscellaneous Manufactured Commodities,July,2007,Q3,July 2007,-3019716256,51770521,3071486777
Miscellaneous Manufactured Commodities,August,2007,Q3,August 2007,-3497432779,56150685,3553583464
Miscellaneous Manufactured Commodities,September,2007,Q3,September 2007,-3743162449,51691031,3794853480
Miscellaneous Manufactured Commodities,October,2007,Q4,October 2007,-4514136220,53232836,4567369056
Miscellaneous Manufactured Commodities,November,2007,Q4,November 2007,-3912358744,50344008,3962702752
Miscellaneous Manufactured Commodities,December,2007,Q4,December 2007,-3052579926,50274267,3102854193
Miscellaneous Manufactured Commodities,January,2008,Q1,January 2008,-2809688537,51196265,2860884802
Miscellaneous Manufactured Commodities,February,2008,Q1,February 2008,-2514529353,50828399,2565357752
Miscellaneous Manufactured Commodities,March,2008,Q1,March 2008,-2059740026,63115855,2122855881
Miscellaneous Manufactured Commodities,April,2008,Q2,April 2008,-2467706648,72584145,2540290793
Miscellaneous Manufactured Commodities,May,2008,Q2,May 2008,-2661020463,73418209,2734438672
Miscellaneous Manufactured Commodities,June,2008,Q2,June 2008,-2669860295,72703078,2742563373
Miscellaneous Manufactured Commodities,July,2008,Q3,July 2008,-3241583035,64234680,3305817715
Miscellaneous Manufactured Commodities,August,2008,Q3,August 2008,-3775733526,60575123,3836308649
Miscellaneous Manufactured Commodities,September,2008,Q3,September 2008,-4318996294,50097999,4369094293
Miscellaneous Manufactured Commodities,October,2008,Q4,October 2008,-4689969516,65993945,4755963461
Miscellaneous Manufactured Commodities,November,2008,Q4,November 2008,-3673548358,63475088,3737023446
Miscellaneous Manufactured Commodities,December,2008,Q4,December 2008,-3002368972,66105696,3068474668
Miscellaneous Manufactured Commodities,January,2009,Q1,January 2009,-2805168003,59874735,2865042738
Miscellaneous Manufactured Commodities,February,2009,Q1,February 2009,-1807558123,61036159,1868594282
Miscellaneous Manufactured Commodities,March,2009,Q1,March 2009,-2112764052,71955175,2184719227
Miscellaneous Manufactured Commodities,April,2009,Q2,April 2009,-2173491885,72936622,2246428507
Miscellaneous Manufactured Commodities,May,2009,Q2,May 2009,-2206509283,79142658,2285651941
Miscellaneous Manufactured Commodities,June,2009,Q2,June 2009,-2052608484,76734289,2129342773
Miscellaneous Manufactured Commodities,July,2009,Q3,July 2009,-2857294798,71046030,2928340828
Miscellaneous Manufactured Commodities,August,2009,Q3,August 2009,-3095578004,100979926,3196557930
Miscellaneous Manufactured Commodities,September,2009,Q3,September 2009,-3566932589,110717842,3677650431
Miscellaneous Manufactured Commodities,October,2009,Q4,October 2009,-3849982007,76857930,3926839937
Miscellaneous Manufactured Commodities,November,2009,Q4,November 2009,-3388556525,77006474,3465562999
Miscellaneous Manufactured Commodities,December,2009,Q4,December 2009,-2540622810,93747626,2634370436
Miscellaneous Manufactured Commodities,January,2010,Q1,January 2010,-2356267431,75223620,2431491051
Miscellaneous Manufactured Commodities,February,2010,Q1,February 2010,-2209733173,73314816,2283047989
Miscellaneous Manufactured Commodities,March,2010,Q1,March 2010,-2085571579,107564158,2193135737
Miscellaneous Manufactured Commodities,April,2010,Q2,April 2010,-2223490669,109673469,2333164138
Miscellaneous Manufactured Commodities,May,2010,Q2,May 2010,-2552940269,148121787,2701062056
Miscellaneous Manufactured Commodities,June,2010,Q2,June 2010,-2483531777,151885185,2635416962
Miscellaneous Manufactured Commodities,July,2010,Q3,July 2010,-2863011097,144078147,3007089244
Miscellaneous Manufactured Commodities,August,2010,Q3,August 2010,-3797843738,138315881,3936159619
Miscellaneous Manufactured Commodities,September,2010,Q3,September 2010,-4022078895,126286775,4148365670
Miscellaneous Manufactured Commodities,October,2010,Q4,October 2010,-4478282263,151885498,4630167761
Miscellaneous Manufactured Commodities,November,2010,Q4,November 2010,-3996879322,146881142,4143760464
Miscellaneous Manufactured Commodities,December,2010,Q4,December 2010,-2914341946,148569358,3062911304
Miscellaneous Manufactured Commodities,January,2011,Q1,January 2011,-2783807785,121550455,2905358240
Miscellaneous Manufactured Commodities,February,2011,Q1,February 2011,-2120015834,137261749,2257277583
Miscellaneous Manufactured Commodities,March,2011,Q1,March 2011,-2024600862,168475053,2193075915
Miscellaneous Manufactured Commodities,April,2011,Q2,April 2011,-2262570552,158220077,2420790629
Miscellaneous Manufactured Commodities,May,2011,Q2,May 2011,-2449731612,143117964,2592849576
Miscellaneous Manufactured Commodities,June,2011,Q2,June 2011,-2246643037,180045806,2426688843
Miscellaneous Manufactured Commodities,July,2011,Q3,July 2011,-2933456138,178141802,3111597940
Miscellaneous Manufactured Commodities,August,2011,Q3,August 2011,-3665942982,172815714,3838758696
Miscellaneous Manufactured Commodities,September,2011,Q3,September 2011,-3810455053,150911274,3961366327
Miscellaneous Manufactured Commodities,October,2011,Q4,October 2011,-3997013665,232231302,4229244967
Miscellaneous Manufactured Commodities,November,2011,Q4,November 2011,-3687514842,174000514,3861515356
Miscellaneous Manufactured Commodities,December,2011,Q4,December 2011,-2406197467,185574582,2591772049
Miscellaneous Manufactured Commodities,January,2012,Q1,January 2012,-2926996425,136029794,3063026219
Miscellaneous Manufactured Commodities,February,2012,Q1,February 2012,-2032931273,168381636,2201312909
Miscellaneous Manufactured Commodities,March,2012,Q1,March 2012,-1942217504,212173809,2154391313
Miscellaneous Manufactured Commodities,April,2012,Q2,April 2012,-2295322371,162664335,2457986706
Miscellaneous Manufactured Commodities,May,2012,Q2,May 2012,-2478861854,181474569,2660336423
Miscellaneous Manufactured Commodities,June,2012,Q2,June 2012,-2286521494,185781075,2472302569
Miscellaneous Manufactured Commodities,July,2012,Q3,July 2012,-2895168210,195728582,3090896792
Miscellaneous Manufactured Commodities,August,2012,Q3,August 2012,-3272753674,199517411,3472271085
Miscellaneous Manufactured Commodities,September,2012,Q3,September 2012,-3719032349,164374965,3883407314
Miscellaneous Manufactured Commodities,October,2012,Q4,October 2012,-3972032215,194638583,4166670798
Miscellaneous Manufactured Commodities,November,2012,Q4,November 2012,-3705620278,140683012,3846303290
Miscellaneous Manufactured Commodities,December,2012,Q4,December 2012,-2539556680,165535309,2705091989
Miscellaneous Manufactured Commodities,January,2013,Q1,January 2013,-2820945863,152030782,2972976645
Miscellaneous Manufactured Commodities,February,2013,Q1,February 2013,-2538249550,130159998,2668409548
Miscellaneous Manufactured Commodities,March,2013,Q1,March 2013,-1564244400,208805403,1773049803
Miscellaneous Manufactured Commodities,April,2013,Q2,April 2013,-2060541213,154267202,2214808415
Miscellaneous Manufactured Commodities,May,2013,Q2,May 2013,-2149982691,192001655,2341984346
Miscellaneous Manufactured Commodities,June,2013,Q2,June 2013,-2142316400,192914473,2335230873
Miscellaneous Manufactured Commodities,July,2013,Q3,July 2013,-2804387239,179900067,2984287306
Miscellaneous Manufactured Commodities,August,2013,Q3,August 2013,-3309692310,194387148,3504079458
Miscellaneous Manufactured Commodities,September,2013,Q3,September 2013,-3746138971,191507367,3937646338
Miscellaneous Manufactured Commodities,October,2013,Q4,October 2013,-4552634464,199308763,4751943227
Miscellaneous Manufactured Commodities,November,2013,Q4,November 2013,-3570712053,170816334,3741528387
Miscellaneous Manufactured Commodities,December,2013,Q4,December 2013,-2772172697,162177335,2934350032
Miscellaneous Manufactured Commodities,January,2014,Q1,January 2014,-2849143418,142806693,2991950111
Miscellaneous Manufactured Commodities,February,2014,Q1,February 2014,-2191571149,171126393,2362697542
Miscellaneous Manufactured Commodities,March,2014,Q1,March 2014,-2020051537,201263173,2221314710
Miscellaneous Manufactured Commodities,April,2014,Q2,April 2014,-2342196299,190214593,2532410892
Miscellaneous Manufactured Commodities,May,2014,Q2,May 2014,-2353302254,205211083,2558513337
Miscellaneous Manufactured Commodities,June,2014,Q2,June 2014,-2389333114,213024760,2602357874
Miscellaneous Manufactured Commodities,July,2014,Q3,July 2014,-3095821817,199708630,3295530447
Miscellaneous Manufactured Commodities,August,2014,Q3,August 2014,-3352092905,253234889,3605327794
Miscellaneous Manufactured Commodities,September,2014,Q3,September 2014,-4052068234,181558951,4233627185
Miscellaneous Manufactured Commodities,October,2014,Q4,October 2014,-4332254135,225115469,4557369604
Miscellaneous Manufactured Commodities,November,2014,Q4,November 2014,-3627128846,210806913,3837935759
Miscellaneous Manufactured Commodities,December,2014,Q4,December 2014,-2717564513,186974331,2904538844
Miscellaneous Manufactured Commodities,January,2015,Q1,January 2015,-2582138191,196053722,2778191913
Miscellaneous Manufactured Commodities,February,2015,Q1,February 2015,-2337561677,162105860,2499667537
Miscellaneous Manufactured Commodities,March,2015,Q1,March 2015,-2578929088,250284475,2829213563
Miscellaneous Manufactured Commodities,April,2015,Q2,April 2015,-2193932227,199309916,2393242143
Miscellaneous Manufactured Commodities,May,2015,Q2,May 2015,-2539379512,238123091,2777502603
Miscellaneous Manufactured Commodities,June,2015,Q2,June 2015,-2723706118,258448104,2982154222
Miscellaneous Manufactured Commodities,July,2015,Q3,July 2015,-3217789913,205545966,3423335879
Miscellaneous Manufactured Commodities,August,2015,Q3,August 2015,-4163776221,216105744,4379881965
Miscellaneous Manufactured Commodities,September,2015,Q3,September 2015,-4399251163,215309170,4614560333
Miscellaneous Manufactured Commodities,October,2015,Q4,October 2015,-4461070878,228637953,4689708831
Miscellaneous Manufactured Commodities,November,2015,Q4,November 2015,-3664650815,201197525,3865848340
Miscellaneous Manufactured Commodities,December,2015,Q4,December 2015,-2668852540,215729261,2884581801
Miscellaneous Manufactured Commodities,January,2016,Q1,January 2016,-2695999912,217575014,2913574926
Miscellaneous Manufactured Commodities,February,2016,Q1,February 2016,-2861871079,184144621,3046015700
Miscellaneous Manufactured Commodities,March,2016,Q1,March 2016,-1724307807,253444568,1977752375
Miscellaneous Manufactured Commodities,April,2016,Q2,April 2016,-2163607459,266477792,2430085251
Miscellaneous Manufactured Commodities,May,2016,Q2,May 2016,-2543980600,231719355,2775699955
Miscellaneous Manufactured Commodities,June,2016,Q2,June 2016,-2562764542,237573909,2800338451
Miscellaneous Manufactured Commodities,July,2016,Q3,July 2016,-3245563485,246753107,3492316592
Miscellaneous Manufactured Commodities,August,2016,Q3,August 2016,-3865318825,268085211,4133404036
Miscellaneous Manufactured Commodities,September,2016,Q3,September 2016,-4138660206,238337213,4376997419
Miscellaneous Manufactured Commodities,October,2016,Q4,October 2016,-4559849647,247388723,4807238370
Miscellaneous Manufactured Commodities,November,2016,Q4,November 2016,-3518638519,254157274,3772795793
Miscellaneous Manufactured Commodities,December,2016,Q4,December 2016,-2615441619,250562365,2866003984
Miscellaneous Manufactured Commodities,January,2017,Q1,January 2017,-2971671105,201177344,3172848449
Miscellaneous Manufactured Commodities,February,2017,Q1,February 2017,-2303540689,241983690,2545524379
Miscellaneous Manufactured Commodities,March,2017,Q1,March 2017,-1952082664,290272134,2242354798
Miscellaneous Manufactured Commodities,April,2017,Q2,April 2017,-2293429349,259201581,2552630930
Miscellaneous Manufactured Commodities,May,2017,Q2,May 2017,-2705522043,288534797,2994056840
Miscellaneous Manufactured Commodities,June,2017,Q2,June 2017,-2755615773,291578637,3047194410
Miscellaneous Manufactured Commodities,July,2017,Q3,July 2017,-3302978581,258621631,3561600212
Miscellaneous Manufactured Commodities,August,2017,Q3,August 2017,-3998170523,271765952,4269936475
Miscellaneous Manufactured Commodities,September,2017,Q3,September 2017,-4209219694,275661654,4484881348
Miscellaneous Manufactured Commodities,October,2017,Q4,October 2017,-4918692942,272356503,5191049445
Miscellaneous Manufactured Commodities,November,2017,Q4,November 2017,-3854446911,275107087,4129553998
Miscellaneous Manufactured Commodities,December,2017,Q4,December 2017,-2789931782,283090414,3073022196
Miscellaneous Manufactured Commodities,January,2018,Q1,January 2018,-3145278953,262396083,3407675036
Miscellaneous Manufactured Commodities,February,2018,Q1,February 2018,-2840109140,247000067,3087109207
Miscellaneous Manufactured Commodities,March,2018,Q1,March 2018,-2134245456,342633919,2476879375
Miscellaneous Manufactured Commodities,April,2018,Q2,April 2018,-2235539795,310231552,2545771347
Miscellaneous Manufactured Commodities,May,2018,Q2,May 2018,-2575832765,317218681,2893051446
Miscellaneous Manufactured Commodities,June,2018,Q2,June 2018,-2889206733,332119724,3221326457
Miscellaneous Manufactured Commodities,July,2018,Q3,July 2018,-3551421644,325070131,3876491775
Miscellaneous Manufactured Commodities,August,2018,Q3,August 2018,-3973271756,349933178,4323204934
Miscellaneous Manufactured Commodities,September,2018,Q3,September 2018,-4597510208,319098138,4916608346
Miscellaneous Manufactured Commodities,October,2018,Q4,October 2018,-5319512827,326764043,5646276870
Miscellaneous Manufactured Commodities,November,2018,Q4,November 2018,-4107076103,286732051,4393808154
Miscellaneous Manufactured Commodities,December,2018,Q4,December 2018,-2817687860,284088204,3101776064
Miscellaneous Manufactured Commodities,January,2019,Q1,January 2019,-3120811218,307214252,3428025470
Miscellaneous Manufactured Commodities,February,2019,Q1,February 2019,-2451505378,286099360,2737604738
Miscellaneous Manufactured Commodities,March,2019,Q1,March 2019,-1948374926,379332700,2327707626
Miscellaneous Manufactured Commodities,April,2019,Q2,April 2019,-2429606730,314786926,2744393656
Miscellaneous Manufactured Commodities,May,2019,Q2,May 2019,-2697558582,444219942,3141778524
Miscellaneous Manufactured Commodities,June,2019,Q2,June 2019,-2851596587,348084028,3199680615
Miscellaneous Manufactured Commodities,July,2019,Q3,July 2019,-4072994699,313053243,4386047942
Miscellaneous Manufactured Commodities,August,2019,Q3,August 2019,-4886276261,377685673,5263961934
Miscellaneous Manufactured Commodities,September,2019,Q3,September 2019,-4374355272,297233840,4671589112
Miscellaneous Manufactured Commodities,October,2019,Q4,October 2019,-4122078199,405965940,4528044139
Miscellaneous Manufactured Commodities,November,2019,Q4,November 2019,-3175095042,356795697,3531890739
Miscellaneous Manufactured Commodities,December,2019,Q4,December 2019,-2545651720,312481567,2858133287
"Newspapers, Books & Other Published Matter, Nesoi",January,2002,Q1,January 2002,,,
"Newspapers, Books & Other Published Matter, Nesoi",February,2002,Q1,February 2002,,,
"Newspapers, Books & Other Published Matter, Nesoi",March,2002,Q1,March 2002,,,
"Newspapers, Books & Other Published Matter, Nesoi",April,2002,Q2,April 2002,,,
"Newspapers, Books & Other Published Matter, Nesoi",May,2002,Q2,May 2002,,,
"Newspapers, Books & Other Published Matter, Nesoi",June,2002,Q2,June 2002,,,
"Newspapers, Books & Other Published Matter, Nesoi",July,2002,Q3,July 2002,,,
"Newspapers, Books & Other Published Matter, Nesoi",August,2002,Q3,August 2002,,,
"Newspapers, Books & Other Published Matter, Nesoi",September,2002,Q3,September 2002,,,
"Newspapers, Books & Other Published Matter, Nesoi",October,2002,Q4,October 2002,,,
"Newspapers, Books & Other Published Matter, Nesoi",November,2002,Q4,November 2002,,,
"Newspapers, Books & Other Published Matter, Nesoi",December,2002,Q4,December 2002,,,
"Newspapers, Books & Other Published Matter, Nesoi",January,2003,Q1,January 2003,-10299,208596,218895
"Newspapers, Books & Other Published Matter, Nesoi",February,2003,Q1,February 2003,-33941,158182,192123
"Newspapers, Books & Other Published Matter, Nesoi",March,2003,Q1,March 2003,-669691,57574,727265
"Newspapers, Books & Other Published Matter, Nesoi",April,2003,Q2,April 2003,-359074,30318,389392
"Newspapers, Books & Other Published Matter, Nesoi",May,2003,Q2,May 2003,-350796,91664,442460
"Newspapers, Books & Other Published Matter, Nesoi",June,2003,Q2,June 2003,-115604,21254,136858
"Newspapers, Books & Other Published Matter, Nesoi",July,2003,Q3,July 2003,-150790,28086,178876
"Newspapers, Books & Other Published Matter, Nesoi",August,2003,Q3,August 2003,-96530,28717,125247
"Newspapers, Books & Other Published Matter, Nesoi",September,2003,Q3,September 2003,-376892,27068,403960
"Newspapers, Books & Other Published Matter, Nesoi",October,2003,Q4,October 2003,-264929,39143,304072
"Newspapers, Books & Other Published Matter, Nesoi",November,2003,Q4,November 2003,-820011,115441,935452
"Newspapers, Books & Other Published Matter, Nesoi",December,2003,Q4,December 2003,-542189,15290,557479
"Newspapers, Books & Other Published Matter, Nesoi",January,2004,Q1,January 2004,4997951,5199511,201560
"Newspapers, Books & Other Published Matter, Nesoi",February,2004,Q1,February 2004,502207,868114,365907
"Newspapers, Books & Other Published Matter, Nesoi",March,2004,Q1,March 2004,1897183,2151682,254499
"Newspapers, Books & Other Published Matter, Nesoi",April,2004,Q2,April 2004,2345358,2659431,314073
"Newspapers, Books & Other Published Matter, Nesoi",May,2004,Q2,May 2004,2956971,3080222,123251
"Newspapers, Books & Other Published Matter, Nesoi",June,2004,Q2,June 2004,3626101,3841468,215367
"Newspapers, Books & Other Published Matter, Nesoi",July,2004,Q3,July 2004,1173238,1433221,259983
"Newspapers, Books & Other Published Matter, Nesoi",August,2004,Q3,August 2004,1971104,2121334,150230
"Newspapers, Books & Other Published Matter, Nesoi",September,2004,Q3,September 2004,1896014,2086621,190607
"Newspapers, Books & Other Published Matter, Nesoi",October,2004,Q4,October 2004,2292023,2438820,146797
"Newspapers, Books & Other Published Matter, Nesoi",November,2004,Q4,November 2004,1096266,1878884,782618
"Newspapers, Books & Other Published Matter, Nesoi",December,2004,Q4,December 2004,3948047,4835962,887915
"Newspapers, Books & Other Published Matter, Nesoi",January,2005,Q1,January 2005,3670108,4321124,651016
"Newspapers, Books & Other Published Matter, Nesoi",February,2005,Q1,February 2005,46161,1574908,1528747
"Newspapers, Books & Other Published Matter, Nesoi",March,2005,Q1,March 2005,912795,2341507,1428712
"Newspapers, Books & Other Published Matter, Nesoi",April,2005,Q2,April 2005,1525728,2437791,912063
"Newspapers, Books & Other Published Matter, Nesoi",May,2005,Q2,May 2005,2502267,2963553,461286
"Newspapers, Books & Other Published Matter, Nesoi",June,2005,Q2,June 2005,4743081,5131237,388156
"Newspapers, Books & Other Published Matter, Nesoi",July,2005,Q3,July 2005,3750399,4305748,555349
"Newspapers, Books & Other Published Matter, Nesoi",August,2005,Q3,August 2005,2368949,2607960,239011
"Newspapers, Books & Other Published Matter, Nesoi",September,2005,Q3,September 2005,2164865,3197950,1033085
"Newspapers, Books & Other Published Matter, Nesoi",October,2005,Q4,October 2005,4607492,4847044,239552
"Newspapers, Books & Other Published Matter, Nesoi",November,2005,Q4,November 2005,2251500,2680042,428542
"Newspapers, Books & Other Published Matter, Nesoi",December,2005,Q4,December 2005,3330381,3512303,181922
"Newspapers, Books & Other Published Matter, Nesoi",January,2006,Q1,January 2006,4450007,4599759,149752
"Newspapers, Books & Other Published Matter, Nesoi",February,2006,Q1,February 2006,1672502,2212815,540313
"Newspapers, Books & Other Published Matter, Nesoi",March,2006,Q1,March 2006,13989126,14778463,789337
"Newspapers, Books & Other Published Matter, Nesoi",April,2006,Q2,April 2006,4822315,4947786,125471
"Newspapers, Books & Other Published Matter, Nesoi",May,2006,Q2,May 2006,6961364,7149308,187944
"Newspapers, Books & Other Published Matter, Nesoi",June,2006,Q2,June 2006,2446613,2618589,171976
"Newspapers, Books & Other Published Matter, Nesoi",July,2006,Q3,July 2006,5585123,5686493,101370
"Newspapers, Books & Other Published Matter, Nesoi",August,2006,Q3,August 2006,1881164,3222632,1341468
"Newspapers, Books & Other Published Matter, Nesoi",September,2006,Q3,September 2006,1516508,3118919,1602411
"Newspapers, Books & Other Published Matter, Nesoi",October,2006,Q4,October 2006,4824132,6842719,2018587
"Newspapers, Books & Other Published Matter, Nesoi",November,2006,Q4,November 2006,-767979,1796939,2564918
"Newspapers, Books & Other Published Matter, Nesoi",December,2006,Q4,December 2006,4055429,4905840,850411
"Newspapers, Books & Other Published Matter, Nesoi",January,2007,Q1,January 2007,8979537,9363663,384126
"Newspapers, Books & Other Published Matter, Nesoi",February,2007,Q1,February 2007,1271158,1615255,344097
"Newspapers, Books & Other Published Matter, Nesoi",March,2007,Q1,March 2007,2016799,2295386,278587
"Newspapers, Books & Other Published Matter, Nesoi",April,2007,Q2,April 2007,1374082,2295032,920950
"Newspapers, Books & Other Published Matter, Nesoi",May,2007,Q2,May 2007,1192237,1454246,262009
"Newspapers, Books & Other Published Matter, Nesoi",June,2007,Q2,June 2007,1324254,1822182,497928
"Newspapers, Books & Other Published Matter, Nesoi",July,2007,Q3,July 2007,706813,1092618,385805
"Newspapers, Books & Other Published Matter, Nesoi",August,2007,Q3,August 2007,2208488,2447060,238572
"Newspapers, Books & Other Published Matter, Nesoi",September,2007,Q3,September 2007,1777278,2083673,306395
"Newspapers, Books & Other Published Matter, Nesoi",October,2007,Q4,October 2007,1739229,2019020,279791
"Newspapers, Books & Other Published Matter, Nesoi",November,2007,Q4,November 2007,1018871,1195376,176505
"Newspapers, Books & Other Published Matter, Nesoi",December,2007,Q4,December 2007,67837,1498117,1430280
"Newspapers, Books & Other Published Matter, Nesoi",January,2008,Q1,January 2008,1042853,1151129,108276
"Newspapers, Books & Other Published Matter, Nesoi",February,2008,Q1,February 2008,893964,1087772,193808
"Newspapers, Books & Other Published Matter, Nesoi",March,2008,Q1,March 2008,2190068,2328659,138591
"Newspapers, Books & Other Published Matter, Nesoi",April,2008,Q2,April 2008,1548475,1712589,164114
"Newspapers, Books & Other Published Matter, Nesoi",May,2008,Q2,May 2008,1532158,1752181,220023
"Newspapers, Books & Other Published Matter, Nesoi",June,2008,Q2,June 2008,2228357,2546174,317817
"Newspapers, Books & Other Published Matter, Nesoi",July,2008,Q3,July 2008,1310854,1472171,161317
"Newspapers, Books & Other Published Matter, Nesoi",August,2008,Q3,August 2008,1688219,1828429,140210
"Newspapers, Books & Other Published Matter, Nesoi",September,2008,Q3,September 2008,2467885,2569019,101134
"Newspapers, Books & Other Published Matter, Nesoi",October,2008,Q4,October 2008,1810774,1867508,56734
"Newspapers, Books & Other Published Matter, Nesoi",November,2008,Q4,November 2008,1524893,1692380,167487
"Newspapers, Books & Other Published Matter, Nesoi",December,2008,Q4,December 2008,4550873,4744280,193407
"Newspapers, Books & Other Published Matter, Nesoi",January,2009,Q1,January 2009,2952873,3387993,435120
"Newspapers, Books & Other Published Matter, Nesoi",February,2009,Q1,February 2009,1181532,1676358,494826
"Newspapers, Books & Other Published Matter, Nesoi",March,2009,Q1,March 2009,1832644,2409755,577111
"Newspapers, Books & Other Published Matter, Nesoi",April,2009,Q2,April 2009,2815133,3118082,302949
"Newspapers, Books & Other Published Matter, Nesoi",May,2009,Q2,May 2009,1475654,2731732,1256078
"Newspapers, Books & Other Published Matter, Nesoi",June,2009,Q2,June 2009,3225408,4303088,1077680
"Newspapers, Books & Other Published Matter, Nesoi",July,2009,Q3,July 2009,4073009,4522004,448995
"Newspapers, Books & Other Published Matter, Nesoi",August,2009,Q3,August 2009,4780040,5059883,279843
"Newspapers, Books & Other Published Matter, Nesoi",September,2009,Q3,September 2009,4274831,4542233,267402
"Newspapers, Books & Other Published Matter, Nesoi",October,2009,Q4,October 2009,3303596,3426088,122492
"Newspapers, Books & Other Published Matter, Nesoi",November,2009,Q4,November 2009,4440646,4879805,439159
"Newspapers, Books & Other Published Matter, Nesoi",December,2009,Q4,December 2009,6045034,6720081,675047
"Newspapers, Books & Other Published Matter, Nesoi",January,2010,Q1,January 2010,4535956,4734508,198552
"Newspapers, Books & Other Published Matter, Nesoi",February,2010,Q1,February 2010,1542817,1923901,381084
"Newspapers, Books & Other Published Matter, Nesoi",March,2010,Q1,March 2010,8337337,8677036,339699
"Newspapers, Books & Other Published Matter, Nesoi",April,2010,Q2,April 2010,3755277,3883765,128488
"Newspapers, Books & Other Published Matter, Nesoi",May,2010,Q2,May 2010,5027941,5158517,130576
"Newspapers, Books & Other Published Matter, Nesoi",June,2010,Q2,June 2010,6081436,6256225,174789
"Newspapers, Books & Other Published Matter, Nesoi",July,2010,Q3,July 2010,4578965,4724771,145806
"Newspapers, Books & Other Published Matter, Nesoi",August,2010,Q3,August 2010,4479755,4628572,148817
"Newspapers, Books & Other Published Matter, Nesoi",September,2010,Q3,September 2010,3855380,4219409,364029
"Newspapers, Books & Other Published Matter, Nesoi",October,2010,Q4,October 2010,4765133,5090232,325099
"Newspapers, Books & Other Published Matter, Nesoi",November,2010,Q4,November 2010,4130395,4410096,279701
"Newspapers, Books & Other Published Matter, Nesoi",December,2010,Q4,December 2010,5098478,5986665,888187
"Newspapers, Books & Other Published Matter, Nesoi",January,2011,Q1,January 2011,3358358,3631255,272897
"Newspapers, Books & Other Published Matter, Nesoi",February,2011,Q1,February 2011,2900061,3031980,131919
"Newspapers, Books & Other Published Matter, Nesoi",March,2011,Q1,March 2011,6106670,6398724,292054
"Newspapers, Books & Other Published Matter, Nesoi",April,2011,Q2,April 2011,4964422,5186378,221956
"Newspapers, Books & Other Published Matter, Nesoi",May,2011,Q2,May 2011,3441721,3768479,326758
"Newspapers, Books & Other Published Matter, Nesoi",June,2011,Q2,June 2011,3744063,4002862,258799
"Newspapers, Books & Other Published Matter, Nesoi",July,2011,Q3,July 2011,2485631,2800875,315244
"Newspapers, Books & Other Published Matter, Nesoi",August,2011,Q3,August 2011,2734138,4225823,1491685
"Newspapers, Books & Other Published Matter, Nesoi",September,2011,Q3,September 2011,4573706,4784566,210860
"Newspapers, Books & Other Published Matter, Nesoi",October,2011,Q4,October 2011,2977163,3195326,218163
"Newspapers, Books & Other Published Matter, Nesoi",November,2011,Q4,November 2011,3524062,3861523,337461
"Newspapers, Books & Other Published Matter, Nesoi",December,2011,Q4,December 2011,6184400,6284315,99915
"Newspapers, Books & Other Published Matter, Nesoi",January,2012,Q1,January 2012,,,
"Newspapers, Books & Other Published Matter, Nesoi",February,2012,Q1,February 2012,,,
"Newspapers, Books & Other Published Matter, Nesoi",March,2012,Q1,March 2012,,,
"Newspapers, Books & Other Published Matter, Nesoi",April,2012,Q2,April 2012,,,
"Newspapers, Books & Other Published Matter, Nesoi",May,2012,Q2,May 2012,,,
"Newspapers, Books & Other Published Matter, Nesoi",June,2012,Q2,June 2012,,,
"Newspapers, Books & Other Published Matter, Nesoi",July,2012,Q3,July 2012,,,
"Newspapers, Books & Other Published Matter, Nesoi",August,2012,Q3,August 2012,,,
"Newspapers, Books & Other Published Matter, Nesoi",September,2012,Q3,September 2012,,,
"Newspapers, Books & Other Published Matter, Nesoi",October,2012,Q4,October 2012,,,
"Newspapers, Books & Other Published Matter, Nesoi",November,2012,Q4,November 2012,,,
"Newspapers, Books & Other Published Matter, Nesoi",December,2012,Q4,December 2012,,,
"Newspapers, Books & Other Published Matter, Nesoi",January,2013,Q1,January 2013,,,
"Newspapers, Books & Other Published Matter, Nesoi",February,2013,Q1,February 2013,,,
"Newspapers, Books & Other Published Matter, Nesoi",March,2013,Q1,March 2013,,,
"Newspapers, Books & Other Published Matter, Nesoi",April,2013,Q2,April 2013,,,
"Newspapers, Books & Other Published Matter, Nesoi",May,2013,Q2,May 2013,,,
"Newspapers, Books & Other Published Matter, Nesoi",June,2013,Q2,June 2013,,,
"Newspapers, Books & Other Published Matter, Nesoi",July,2013,Q3,July 2013,,,
"Newspapers, Books & Other Published Matter, Nesoi",August,2013,Q3,August 2013,,,
"Newspapers, Books & Other Published Matter, Nesoi",September,2013,Q3,September 2013,,,
"Newspapers, Books & Other Published Matter, Nesoi",October,2013,Q4,October 2013,,,
"Newspapers, Books & Other Published Matter, Nesoi",November,2013,Q4,November 2013,,,
"Newspapers, Books & Other Published Matter, Nesoi",December,2013,Q4,December 2013,,,
"Newspapers, Books & Other Published Matter, Nesoi",January,2014,Q1,January 2014,,,
"Newspapers, Books & Other Published Matter, Nesoi",February,2014,Q1,February 2014,,,
"Newspapers, Books & Other Published Matter, Nesoi",March,2014,Q1,March 2014,,,
"Newspapers, Books & Other Published Matter, Nesoi",April,2014,Q2,April 2014,,,
"Newspapers, Books & Other Published Matter, Nesoi",May,2014,Q2,May 2014,,,
"Newspapers, Books & Other Published Matter, Nesoi",June,2014,Q2,June 2014,,,
"Newspapers, Books & Other Published Matter, Nesoi",July,2014,Q3,July 2014,,,
"Newspapers, Books & Other Published Matter, Nesoi",August,2014,Q3,August 2014,,,
"Newspapers, Books & Other Published Matter, Nesoi",September,2014,Q3,September 2014,,,
"Newspapers, Books & Other Published Matter, Nesoi",October,2014,Q4,October 2014,,,
"Newspapers, Books & Other Published Matter, Nesoi",November,2014,Q4,November 2014,,,
"Newspapers, Books & Other Published Matter, Nesoi",December,2014,Q4,December 2014,,,
"Newspapers, Books & Other Published Matter, Nesoi",January,2015,Q1,January 2015,,,
"Newspapers, Books & Other Published Matter, Nesoi",February,2015,Q1,February 2015,,,
"Newspapers, Books & Other Published Matter, Nesoi",March,2015,Q1,March 2015,,,
"Newspapers, Books & Other Published Matter, Nesoi",April,2015,Q2,April 2015,,,
"Newspapers, Books & Other Published Matter, Nesoi",May,2015,Q2,May 2015,,,
"Newspapers, Books & Other Published Matter, Nesoi",June,2015,Q2,June 2015,,,
"Newspapers, Books & Other Published Matter, Nesoi",July,2015,Q3,July 2015,,,
"Newspapers, Books & Other Published Matter, Nesoi",August,2015,Q3,August 2015,,,
"Newspapers, Books & Other Published Matter, Nesoi",September,2015,Q3,September 2015,,,
"Newspapers, Books & Other Published Matter, Nesoi",October,2015,Q4,October 2015,,,
"Newspapers, Books & Other Published Matter, Nesoi",November,2015,Q4,November 2015,,,
"Newspapers, Books & Other Published Matter, Nesoi",December,2015,Q4,December 2015,,,
"Newspapers, Books & Other Published Matter, Nesoi",January,2016,Q1,January 2016,,,
"Newspapers, Books & Other Published Matter, Nesoi",February,2016,Q1,February 2016,,,
"Newspapers, Books & Other Published Matter, Nesoi",March,2016,Q1,March 2016,,,
"Newspapers, Books & Other Published Matter, Nesoi",April,2016,Q2,April 2016,,,
"Newspapers, Books & Other Published Matter, Nesoi",May,2016,Q2,May 2016,,,
"Newspapers, Books & Other Published Matter, Nesoi",June,2016,Q2,June 2016,,,
"Newspapers, Books & Other Published Matter, Nesoi",July,2016,Q3,July 2016,,,
"Newspapers, Books & Other Published Matter, Nesoi",August,2016,Q3,August 2016,,,
"Newspapers, Books & Other Published Matter, Nesoi",September,2016,Q3,September 2016,,,
"Newspapers, Books & Other Published Matter, Nesoi",October,2016,Q4,October 2016,,,
"Newspapers, Books & Other Published Matter, Nesoi",November,2016,Q4,November 2016,,,
"Newspapers, Books & Other Published Matter, Nesoi",December,2016,Q4,December 2016,,,
"Newspapers, Books & Other Published Matter, Nesoi",January,2017,Q1,January 2017,,,
"Newspapers, Books & Other Published Matter, Nesoi",February,2017,Q1,February 2017,,,
"Newspapers, Books & Other Published Matter, Nesoi",March,2017,Q1,March 2017,,,
"Newspapers, Books & Other Published Matter, Nesoi",April,2017,Q2,April 2017,,,
"Newspapers, Books & Other Published Matter, Nesoi",May,2017,Q2,May 2017,,,
"Newspapers, Books & Other Published Matter, Nesoi",June,2017,Q2,June 2017,,,
"Newspapers, Books & Other Published Matter, Nesoi",July,2017,Q3,July 2017,,,
"Newspapers, Books & Other Published Matter, Nesoi",August,2017,Q3,August 2017,,,
"Newspapers, Books & Other Published Matter, Nesoi",September,2017,Q3,September 2017,,,
"Newspapers, Books & Other Published Matter, Nesoi",October,2017,Q4,October 2017,,,
"Newspapers, Books & Other Published Matter, Nesoi",November,2017,Q4,November 2017,,,
"Newspapers, Books & Other Published Matter, Nesoi",December,2017,Q4,December 2017,,,
"Newspapers, Books & Other Published Matter, Nesoi",January,2018,Q1,January 2018,,,
"Newspapers, Books & Other Published Matter, Nesoi",February,2018,Q1,February 2018,,,
"Newspapers, Books & Other Published Matter, Nesoi",March,2018,Q1,March 2018,,,
"Newspapers, Books & Other Published Matter, Nesoi",April,2018,Q2,April 2018,,,
"Newspapers, Books & Other Published Matter, Nesoi",May,2018,Q2,May 2018,,,
"Newspapers, Books & Other Published Matter, Nesoi",June,2018,Q2,June 2018,,,
"Newspapers, Books & Other Published Matter, Nesoi",July,2018,Q3,July 2018,,,
"Newspapers, Books & Other Published Matter, Nesoi",August,2018,Q3,August 2018,,,
"Newspapers, Books & Other Published Matter, Nesoi",September,2018,Q3,September 2018,,,
"Newspapers, Books & Other Published Matter, Nesoi",October,2018,Q4,October 2018,,,
"Newspapers, Books & Other Published Matter, Nesoi",November,2018,Q4,November 2018,,,
"Newspapers, Books & Other Published Matter, Nesoi",December,2018,Q4,December 2018,,,
"Newspapers, Books & Other Published Matter, Nesoi",January,2019,Q1,January 2019,,,
"Newspapers, Books & Other Published Matter, Nesoi",February,2019,Q1,February 2019,,,
"Newspapers, Books & Other Published Matter, Nesoi",March,2019,Q1,March 2019,,,
"Newspapers, Books & Other Published Matter, Nesoi",April,2019,Q2,April 2019,,,
"Newspapers, Books & Other Published Matter, Nesoi",May,2019,Q2,May 2019,,,
"Newspapers, Books & Other Published Matter, Nesoi",June,2019,Q2,June 2019,,,
"Newspapers, Books & Other Published Matter, Nesoi",July,2019,Q3,July 2019,,,
"Newspapers, Books & Other Published Matter, Nesoi",August,2019,Q3,August 2019,,,
"Newspapers, Books & Other Published Matter, Nesoi",September,2019,Q3,September 2019,,,
"Newspapers, Books & Other Published Matter, Nesoi",October,2019,Q4,October 2019,,,
"Newspapers, Books & Other Published Matter, Nesoi",November,2019,Q4,November 2019,,,
"Newspapers, Books & Other Published Matter, Nesoi",December,2019,Q4,December 2019,,,
Published Printed Music And Music Manuscr,January,2002,Q1,January 2002,,,
Published Printed Music And Music Manuscr,February,2002,Q1,February 2002,,,
Published Printed Music And Music Manuscr,March,2002,Q1,March 2002,,,
Published Printed Music And Music Manuscr,April,2002,Q2,April 2002,,,
Published Printed Music And Music Manuscr,May,2002,Q2,May 2002,,,
Published Printed Music And Music Manuscr,June,2002,Q2,June 2002,,,
Published Printed Music And Music Manuscr,July,2002,Q3,July 2002,,,
Published Printed Music And Music Manuscr,August,2002,Q3,August 2002,,,
Published Printed Music And Music Manuscr,September,2002,Q3,September 2002,,,
Published Printed Music And Music Manuscr,October,2002,Q4,October 2002,,,
Published Printed Music And Music Manuscr,November,2002,Q4,November 2002,,,
Published Printed Music And Music Manuscr,December,2002,Q4,December 2002,,,
Published Printed Music And Music Manuscr,January,2003,Q1,January 2003,,,
Published Printed Music And Music Manuscr,February,2003,Q1,February 2003,,,
Published Printed Music And Music Manuscr,March,2003,Q1,March 2003,,,
Published Printed Music And Music Manuscr,April,2003,Q2,April 2003,,,
Published Printed Music And Music Manuscr,May,2003,Q2,May 2003,,,
Published Printed Music And Music Manuscr,June,2003,Q2,June 2003,,,
Published Printed Music And Music Manuscr,July,2003,Q3,July 2003,,,
Published Printed Music And Music Manuscr,August,2003,Q3,August 2003,,,
Published Printed Music And Music Manuscr,September,2003,Q3,September 2003,,,
Published Printed Music And Music Manuscr,October,2003,Q4,October 2003,,,
Published Printed Music And Music Manuscr,November,2003,Q4,November 2003,,,
Published Printed Music And Music Manuscr,December,2003,Q4,December 2003,,,
Published Printed Music And Music Manuscr,January,2004,Q1,January 2004,,,
Published Printed Music And Music Manuscr,February,2004,Q1,February 2004,,,
Published Printed Music And Music Manuscr,March,2004,Q1,March 2004,,,
Published Printed Music And Music Manuscr,April,2004,Q2,April 2004,,,
Published Printed Music And Music Manuscr,May,2004,Q2,May 2004,,,
Published Printed Music And Music Manuscr,June,2004,Q2,June 2004,,,
Published Printed Music And Music Manuscr,July,2004,Q3,July 2004,,,
Published Printed Music And Music Manuscr,August,2004,Q3,August 2004,,,
Published Printed Music And Music Manuscr,September,2004,Q3,September 2004,,,
Published Printed Music And Music Manuscr,October,2004,Q4,October 2004,,,
Published Printed Music And Music Manuscr,November,2004,Q4,November 2004,,,
Published Printed Music And Music Manuscr,December,2004,Q4,December 2004,,,
Published Printed Music And Music Manuscr,January,2005,Q1,January 2005,,,
Published Printed Music And Music Manuscr,February,2005,Q1,February 2005,,,
Published Printed Music And Music Manuscr,March,2005,Q1,March 2005,,,
Published Printed Music And Music Manuscr,April,2005,Q2,April 2005,,,
Published Printed Music And Music Manuscr,May,2005,Q2,May 2005,,,
Published Printed Music And Music Manuscr,June,2005,Q2,June 2005,,,
Published Printed Music And Music Manuscr,July,2005,Q3,July 2005,,,
Published Printed Music And Music Manuscr,August,2005,Q3,August 2005,,,
Published Printed Music And Music Manuscr,September,2005,Q3,September 2005,,,
Published Printed Music And Music Manuscr,October,2005,Q4,October 2005,,,
Published Printed Music And Music Manuscr,November,2005,Q4,November 2005,,,
Published Printed Music And Music Manuscr,December,2005,Q4,December 2005,,,
Published Printed Music And Music Manuscr,January,2006,Q1,January 2006,,,
Published Printed Music And Music Manuscr,February,2006,Q1,February 2006,,,
Published Printed Music And Music Manuscr,March,2006,Q1,March 2006,,,
Published Printed Music And Music Manuscr,April,2006,Q2,April 2006,,,
Published Printed Music And Music Manuscr,May,2006,Q2,May 2006,,,
Published Printed Music And Music Manuscr,June,2006,Q2,June 2006,,,
Published Printed Music And Music Manuscr,July,2006,Q3,July 2006,,,
Published Printed Music And Music Manuscr,August,2006,Q3,August 2006,,,
Published Printed Music And Music Manuscr,September,2006,Q3,September 2006,,,
Published Printed Music And Music Manuscr,October,2006,Q4,October 2006,,,
Published Printed Music And Music Manuscr,November,2006,Q4,November 2006,,,
Published Printed Music And Music Manuscr,December,2006,Q4,December 2006,,,
Published Printed Music And Music Manuscr,January,2007,Q1,January 2007,,,
Published Printed Music And Music Manuscr,February,2007,Q1,February 2007,,,
Published Printed Music And Music Manuscr,March,2007,Q1,March 2007,,,
Published Printed Music And Music Manuscr,April,2007,Q2,April 2007,,,
Published Printed Music And Music Manuscr,May,2007,Q2,May 2007,,,
Published Printed Music And Music Manuscr,June,2007,Q2,June 2007,,,
Published Printed Music And Music Manuscr,July,2007,Q3,July 2007,,,
Published Printed Music And Music Manuscr,August,2007,Q3,August 2007,,,
Published Printed Music And Music Manuscr,September,2007,Q3,September 2007,,,
Published Printed Music And Music Manuscr,October,2007,Q4,October 2007,,,
Published Printed Music And Music Manuscr,November,2007,Q4,November 2007,,,
Published Printed Music And Music Manuscr,December,2007,Q4,December 2007,,,
Published Printed Music And Music Manuscr,January,2008,Q1,January 2008,,,
Published Printed Music And Music Manuscr,February,2008,Q1,February 2008,,,
Published Printed Music And Music Manuscr,March,2008,Q1,March 2008,,,
Published Printed Music And Music Manuscr,April,2008,Q2,April 2008,,,
Published Printed Music And Music Manuscr,May,2008,Q2,May 2008,,,
Published Printed Music And Music Manuscr,June,2008,Q2,June 2008,,,
Published Printed Music And Music Manuscr,July,2008,Q3,July 2008,,,
Published Printed Music And Music Manuscr,August,2008,Q3,August 2008,,,
Published Printed Music And Music Manuscr,September,2008,Q3,September 2008,,,
Published Printed Music And Music Manuscr,October,2008,Q4,October 2008,,,
Published Printed Music And Music Manuscr,November,2008,Q4,November 2008,,,
Published Printed Music And Music Manuscr,December,2008,Q4,December 2008,,,
Published Printed Music And Music Manuscr,January,2009,Q1,January 2009,,,
Published Printed Music And Music Manuscr,February,2009,Q1,February 2009,,,
Published Printed Music And Music Manuscr,March,2009,Q1,March 2009,,,
Published Printed Music And Music Manuscr,April,2009,Q2,April 2009,,,
Published Printed Music And Music Manuscr,May,2009,Q2,May 2009,,,
Published Printed Music And Music Manuscr,June,2009,Q2,June 2009,,,
Published Printed Music And Music Manuscr,July,2009,Q3,July 2009,,,
Published Printed Music And Music Manuscr,August,2009,Q3,August 2009,,,
Published Printed Music And Music Manuscr,September,2009,Q3,September 2009,,,
Published Printed Music And Music Manuscr,October,2009,Q4,October 2009,,,
Published Printed Music And Music Manuscr,November,2009,Q4,November 2009,,,
Published Printed Music And Music Manuscr,December,2009,Q4,December 2009,,,
Published Printed Music And Music Manuscr,January,2010,Q1,January 2010,,,
Published Printed Music And Music Manuscr,February,2010,Q1,February 2010,,,
Published Printed Music And Music Manuscr,March,2010,Q1,March 2010,,,
Published Printed Music And Music Manuscr,April,2010,Q2,April 2010,,,
Published Printed Music And Music Manuscr,May,2010,Q2,May 2010,,,
Published Printed Music And Music Manuscr,June,2010,Q2,June 2010,,,
Published Printed Music And Music Manuscr,July,2010,Q3,July 2010,,,
Published Printed Music And Music Manuscr,August,2010,Q3,August 2010,,,
Published Printed Music And Music Manuscr,September,2010,Q3,September 2010,,,
Published Printed Music And Music Manuscr,October,2010,Q4,October 2010,,,
Published Printed Music And Music Manuscr,November,2010,Q4,November 2010,,,
Published Printed Music And Music Manuscr,December,2010,Q4,December 2010,,,
Published Printed Music And Music Manuscr,January,2011,Q1,January 2011,,,
Published Printed Music And Music Manuscr,February,2011,Q1,February 2011,,,
Published Printed Music And Music Manuscr,March,2011,Q1,March 2011,,,
Published Printed Music And Music Manuscr,April,2011,Q2,April 2011,,,
Published Printed Music And Music Manuscr,May,2011,Q2,May 2011,,,
Published Printed Music And Music Manuscr,June,2011,Q2,June 2011,,,
Published Printed Music And Music Manuscr,July,2011,Q3,July 2011,,,
Published Printed Music And Music Manuscr,August,2011,Q3,August 2011,,,
Published Printed Music And Music Manuscr,September,2011,Q3,September 2011,,,
Published Printed Music And Music Manuscr,October,2011,Q4,October 2011,,,
Published Printed Music And Music Manuscr,November,2011,Q4,November 2011,,,
Published Printed Music And Music Manuscr,December,2011,Q4,December 2011,,,
Published Printed Music And Music Manuscr,January,2012,Q1,January 2012,,,
Published Printed Music And Music Manuscr,February,2012,Q1,February 2012,,,
Published Printed Music And Music Manuscr,March,2012,Q1,March 2012,,,
Published Printed Music And Music Manuscr,April,2012,Q2,April 2012,,,
Published Printed Music And Music Manuscr,May,2012,Q2,May 2012,,,
Published Printed Music And Music Manuscr,June,2012,Q2,June 2012,,,
Published Printed Music And Music Manuscr,July,2012,Q3,July 2012,,,
Published Printed Music And Music Manuscr,August,2012,Q3,August 2012,,,
Published Printed Music And Music Manuscr,September,2012,Q3,September 2012,,,
Published Printed Music And Music Manuscr,October,2012,Q4,October 2012,,,
Published Printed Music And Music Manuscr,November,2012,Q4,November 2012,,,
Published Printed Music And Music Manuscr,December,2012,Q4,December 2012,,,
Published Printed Music And Music Manuscr,January,2013,Q1,January 2013,,,
Published Printed Music And Music Manuscr,February,2013,Q1,February 2013,,,
Published Printed Music And Music Manuscr,March,2013,Q1,March 2013,,,
Published Printed Music And Music Manuscr,April,2013,Q2,April 2013,,,
Published Printed Music And Music Manuscr,May,2013,Q2,May 2013,,,
Published Printed Music And Music Manuscr,June,2013,Q2,June 2013,,,
Published Printed Music And Music Manuscr,July,2013,Q3,July 2013,,,
Published Printed Music And Music Manuscr,August,2013,Q3,August 2013,,,
Published Printed Music And Music Manuscr,September,2013,Q3,September 2013,,,
Published Printed Music And Music Manuscr,October,2013,Q4,October 2013,,,
Published Printed Music And Music Manuscr,November,2013,Q4,November 2013,,,
Published Printed Music And Music Manuscr,December,2013,Q4,December 2013,,,
Published Printed Music And Music Manuscr,January,2014,Q1,January 2014,,,
Published Printed Music And Music Manuscr,February,2014,Q1,February 2014,,,
Published Printed Music And Music Manuscr,March,2014,Q1,March 2014,,,
Published Printed Music And Music Manuscr,April,2014,Q2,April 2014,,,
Published Printed Music And Music Manuscr,May,2014,Q2,May 2014,,,
Published Printed Music And Music Manuscr,June,2014,Q2,June 2014,,,
Published Printed Music And Music Manuscr,July,2014,Q3,July 2014,,,
Published Printed Music And Music Manuscr,August,2014,Q3,August 2014,,,
Published Printed Music And Music Manuscr,September,2014,Q3,September 2014,,,
Published Printed Music And Music Manuscr,October,2014,Q4,October 2014,,,
Published Printed Music And Music Manuscr,November,2014,Q4,November 2014,,,
Published Printed Music And Music Manuscr,December,2014,Q4,December 2014,,,
Published Printed Music And Music Manuscr,January,2015,Q1,January 2015,,,
Published Printed Music And Music Manuscr,February,2015,Q1,February 2015,,,
Published Printed Music And Music Manuscr,March,2015,Q1,March 2015,,,
Published Printed Music And Music Manuscr,April,2015,Q2,April 2015,,,
Published Printed Music And Music Manuscr,May,2015,Q2,May 2015,,,
Published Printed Music And Music Manuscr,June,2015,Q2,June 2015,,,
Published Printed Music And Music Manuscr,July,2015,Q3,July 2015,,,
Published Printed Music And Music Manuscr,August,2015,Q3,August 2015,,,
Published Printed Music And Music Manuscr,September,2015,Q3,September 2015,,,
Published Printed Music And Music Manuscr,October,2015,Q4,October 2015,,,
Published Printed Music And Music Manuscr,November,2015,Q4,November 2015,,,
Published Printed Music And Music Manuscr,December,2015,Q4,December 2015,,,
Published Printed Music And Music Manuscr,January,2016,Q1,January 2016,,,
Published Printed Music And Music Manuscr,February,2016,Q1,February 2016,,,
Published Printed Music And Music Manuscr,March,2016,Q1,March 2016,,,
Published Printed Music And Music Manuscr,April,2016,Q2,April 2016,,,
Published Printed Music And Music Manuscr,May,2016,Q2,May 2016,,,
Published Printed Music And Music Manuscr,June,2016,Q2,June 2016,,,
Published Printed Music And Music Manuscr,July,2016,Q3,July 2016,,,
Published Printed Music And Music Manuscr,August,2016,Q3,August 2016,,,
Published Printed Music And Music Manuscr,September,2016,Q3,September 2016,,,
Published Printed Music And Music Manuscr,October,2016,Q4,October 2016,,,
Published Printed Music And Music Manuscr,November,2016,Q4,November 2016,,,
Published Printed Music And Music Manuscr,December,2016,Q4,December 2016,,,
Published Printed Music And Music Manuscr,January,2017,Q1,January 2017,,,
Published Printed Music And Music Manuscr,February,2017,Q1,February 2017,,,
Published Printed Music And Music Manuscr,March,2017,Q1,March 2017,,,
Published Printed Music And Music Manuscr,April,2017,Q2,April 2017,,,
Published Printed Music And Music Manuscr,May,2017,Q2,May 2017,,,
Published Printed Music And Music Manuscr,June,2017,Q2,June 2017,,,
Published Printed Music And Music Manuscr,July,2017,Q3,July 2017,,,
Published Printed Music And Music Manuscr,August,2017,Q3,August 2017,,,
Published Printed Music And Music Manuscr,September,2017,Q3,September 2017,,,
Published Printed Music And Music Manuscr,October,2017,Q4,October 2017,,,
Published Printed Music And Music Manuscr,November,2017,Q4,November 2017,,,
Published Printed Music And Music Manuscr,December,2017,Q4,December 2017,,,
Published Printed Music And Music Manuscr,January,2018,Q1,January 2018,,,
Published Printed Music And Music Manuscr,February,2018,Q1,February 2018,,,
Published Printed Music And Music Manuscr,March,2018,Q1,March 2018,,,
Published Printed Music And Music Manuscr,April,2018,Q2,April 2018,,,
Published Printed Music And Music Manuscr,May,2018,Q2,May 2018,,,
Published Printed Music And Music Manuscr,June,2018,Q2,June 2018,,,
Published Printed Music And Music Manuscr,July,2018,Q3,July 2018,,,
Published Printed Music And Music Manuscr,August,2018,Q3,August 2018,,,
Published Printed Music And Music Manuscr,September,2018,Q3,September 2018,,,
Published Printed Music And Music Manuscr,October,2018,Q4,October 2018,,,
Published Printed Music And Music Manuscr,November,2018,Q4,November 2018,,,
Published Printed Music And Music Manuscr,December,2018,Q4,December 2018,,,
Published Printed Music And Music Manuscr,January,2019,Q1,January 2019,,,
Published Printed Music And Music Manuscr,February,2019,Q1,February 2019,,,
Published Printed Music And Music Manuscr,March,2019,Q1,March 2019,,,
Published Printed Music And Music Manuscr,April,2019,Q2,April 2019,,,
Published Printed Music And Music Manuscr,May,2019,Q2,May 2019,,,
Published Printed Music And Music Manuscr,June,2019,Q2,June 2019,,,
Published Printed Music And Music Manuscr,July,2019,Q3,July 2019,,,
Published Printed Music And Music Manuscr,August,2019,Q3,August 2019,,,
Published Printed Music And Music Manuscr,September,2019,Q3,September 2019,,,
Published Printed Music And Music Manuscr,October,2019,Q4,October 2019,,,
Published Printed Music And Music Manuscr,November,2019,Q4,November 2019,,,
Published Printed Music And Music Manuscr,December,2019,Q4,December 2019,,,
Waste And Scrap,January,2002,Q1,January 2002,81942332,83989100,2046768
Waste And Scrap,February,2002,Q1,February 2002,78260936,80353428,2092492
Waste And Scrap,March,2002,Q1,March 2002,81883728,83449673,1565945
Waste And Scrap,April,2002,Q2,April 2002,105427442,107987119,2559677
Waste And Scrap,May,2002,Q2,May 2002,124766508,127544001,2777493
Waste And Scrap,June,2002,Q2,June 2002,87627754,90461411,2833657
Waste And Scrap,July,2002,Q3,July 2002,91147005,94292920,3145915
Waste And Scrap,August,2002,Q3,August 2002,107745704,110723968,2978264
Waste And Scrap,September,2002,Q3,September 2002,89910847,91800781,1889934
Waste And Scrap,October,2002,Q4,October 2002,88987197,90845032,1857835
Waste And Scrap,November,2002,Q4,November 2002,119491926,121285858,1793932
Waste And Scrap,December,2002,Q4,December 2002,126664988,128843019,2178031
Waste And Scrap,January,2003,Q1,January 2003,123743122,125290864,1547742
Waste And Scrap,February,2003,Q1,February 2003,128830472,130545246,1714774
Waste And Scrap,March,2003,Q1,March 2003,140827423,143520035,2692612
Waste And Scrap,April,2003,Q2,April 2003,129170786,131486926,2316140
Waste And Scrap,May,2003,Q2,May 2003,161541869,163866294,2324425
Waste And Scrap,June,2003,Q2,June 2003,140009170,141578130,1568960
Waste And Scrap,July,2003,Q3,July 2003,178058342,180767521,2709179
Waste And Scrap,August,2003,Q3,August 2003,186926436,188896560,1970124
Waste And Scrap,September,2003,Q3,September 2003,153329870,155081408,1751538
Waste And Scrap,October,2003,Q4,October 2003,181758193,185245925,3487732
Waste And Scrap,November,2003,Q4,November 2003,199562678,201697737,2135059
Waste And Scrap,December,2003,Q4,December 2003,191204039,194601159,3397120
Waste And Scrap,January,2004,Q1,January 2004,191074129,196681515,5607386
Waste And Scrap,February,2004,Q1,February 2004,190144284,192706702,2562418
Waste And Scrap,March,2004,Q1,March 2004,214466413,216824775,2358362
Waste And Scrap,April,2004,Q2,April 2004,211054079,213415097,2361018
Waste And Scrap,May,2004,Q2,May 2004,170242346,172228148,1985802
Waste And Scrap,June,2004,Q2,June 2004,154398113,156312873,1914760
Waste And Scrap,July,2004,Q3,July 2004,201233879,204224841,2990962
Waste And Scrap,August,2004,Q3,August 2004,194181577,197237556,3055979
Waste And Scrap,September,2004,Q3,September 2004,214461276,217437054,2975778
Waste And Scrap,October,2004,Q4,October 2004,267243787,269663136,2419349
Waste And Scrap,November,2004,Q4,November 2004,219720354,224866484,5146130
Waste And Scrap,December,2004,Q4,December 2004,246318178,252203393,5885215
Waste And Scrap,January,2005,Q1,January 2005,203326544,208223875,4897331
Waste And Scrap,February,2005,Q1,February 2005,240766237,244497631,3731394
Waste And Scrap,March,2005,Q1,March 2005,269682484,273210995,3528511
Waste And Scrap,April,2005,Q2,April 2005,287568518,291027038,3458520
Waste And Scrap,May,2005,Q2,May 2005,313007142,316898657,3891515
Waste And Scrap,June,2005,Q2,June 2005,305826835,310536840,4710005
Waste And Scrap,July,2005,Q3,July 2005,300455171,304055506,3600335
Waste And Scrap,August,2005,Q3,August 2005,356796245,361072240,4275995
Waste And Scrap,September,2005,Q3,September 2005,330330319,333819989,3489670
Waste And Scrap,October,2005,Q4,October 2005,362983908,368645505,5661597
Waste And Scrap,November,2005,Q4,November 2005,344757015,350127495,5370480
Waste And Scrap,December,2005,Q4,December 2005,322708300,329259399,6551099
Waste And Scrap,January,2006,Q1,January 2006,325763062,334078081,8315019
Waste And Scrap,February,2006,Q1,February 2006,435254332,440200088,4945756
Waste And Scrap,March,2006,Q1,March 2006,438983999,444097103,5113104
Waste And Scrap,April,2006,Q2,April 2006,417150182,425743253,8593071
Waste And Scrap,May,2006,Q2,May 2006,540275344,551024750,10749406
Waste And Scrap,June,2006,Q2,June 2006,474450677,487621856,13171179
Waste And Scrap,July,2006,Q3,July 2006,427926110,439352383,11426273
Waste And Scrap,August,2006,Q3,August 2006,543760741,561740853,17980112
Waste And Scrap,September,2006,Q3,September 2006,553302099,571020980,17718881
Waste And Scrap,October,2006,Q4,October 2006,617975577,633175773,15200196
Waste And Scrap,November,2006,Q4,November 2006,571947638,582207313,10259675
Waste And Scrap,December,2006,Q4,December 2006,567490416,577352702,9862286
Waste And Scrap,January,2007,Q1,January 2007,514417147,526383807,11966660
Waste And Scrap,February,2007,Q1,February 2007,523475614,529109549,5633935
Waste And Scrap,March,2007,Q1,March 2007,566407105,571375492,4968387
Waste And Scrap,April,2007,Q2,April 2007,572921252,578313572,5392320
Waste And Scrap,May,2007,Q2,May 2007,636639743,642410171,5770428
Waste And Scrap,June,2007,Q2,June 2007,581373794,587113132,5739338
Waste And Scrap,July,2007,Q3,July 2007,562071635,569239586,7167951
Waste And Scrap,August,2007,Q3,August 2007,612744996,617407016,4662020
Waste And Scrap,September,2007,Q3,September 2007,615172219,620611736,5439517
Waste And Scrap,October,2007,Q4,October 2007,684960668,687577000,2616332
Waste And Scrap,November,2007,Q4,November 2007,676351173,679618602,3267429
Waste And Scrap,December,2007,Q4,December 2007,713957787,721718957,7761170
Waste And Scrap,January,2008,Q1,January 2008,537441167,547204879,9763712
Waste And Scrap,February,2008,Q1,February 2008,623626610,628404109,4777499
Waste And Scrap,March,2008,Q1,March 2008,614195918,617065839,2869921
Waste And Scrap,April,2008,Q2,April 2008,629646290,637107273,7460983
Waste And Scrap,May,2008,Q2,May 2008,689287502,694604731,5317229
Waste And Scrap,June,2008,Q2,June 2008,724085114,733238363,9153249
Waste And Scrap,July,2008,Q3,July 2008,755484269,767722821,12238552
Waste And Scrap,August,2008,Q3,August 2008,804141998,816052245,11910247
Waste And Scrap,September,2008,Q3,September 2008,743149358,753580507,10431149
Waste And Scrap,October,2008,Q4,October 2008,685874202,692323714,6449512
Waste And Scrap,November,2008,Q4,November 2008,292615331,298773799,6158468
Waste And Scrap,December,2008,Q4,December 2008,321513424,327387557,5874133
Waste And Scrap,January,2009,Q1,January 2009,321496470,325693411,4196941
Waste And Scrap,February,2009,Q1,February 2009,463644429,469347238,5702809
Waste And Scrap,March,2009,Q1,March 2009,737103060,741900646,4797586
Waste And Scrap,April,2009,Q2,April 2009,536583982,544343146,7759164
Waste And Scrap,May,2009,Q2,May 2009,642844486,649128116,6283630
Waste And Scrap,June,2009,Q2,June 2009,607618444,615347833,7729389
Waste And Scrap,July,2009,Q3,July 2009,556293126,563439214,7146088
Waste And Scrap,August,2009,Q3,August 2009,715637943,725352035,9714092
Waste And Scrap,September,2009,Q3,September 2009,626788545,634640676,7852131
Waste And Scrap,October,2009,Q4,October 2009,561563646,566932178,5368532
Waste And Scrap,November,2009,Q4,November 2009,676957565,682476269,5518704
Waste And Scrap,December,2009,Q4,December 2009,650256485,657858493,7602008
Waste And Scrap,January,2010,Q1,January 2010,579338177,582673957,3335780
Waste And Scrap,February,2010,Q1,February 2010,672372827,679727025,7354198
Waste And Scrap,March,2010,Q1,March 2010,702923079,711967972,9044893
Waste And Scrap,April,2010,Q2,April 2010,681922586,688744929,6822343
Waste And Scrap,May,2010,Q2,May 2010,718163189,728418954,10255765
Waste And Scrap,June,2010,Q2,June 2010,696650279,705021622,8371343
Waste And Scrap,July,2010,Q3,July 2010,704390960,712139933,7748973
Waste And Scrap,August,2010,Q3,August 2010,688808770,700923563,12114793
Waste And Scrap,September,2010,Q3,September 2010,675497601,683747872,8250271
Waste And Scrap,October,2010,Q4,October 2010,804332689,816241063,11908374
Waste And Scrap,November,2010,Q4,November 2010,807235830,816316835,9081005
Waste And Scrap,December,2010,Q4,December 2010,767082392,776961800,9879408
Waste And Scrap,January,2011,Q1,January 2011,723103364,731894128,8790764
Waste And Scrap,February,2011,Q1,February 2011,828973383,832983723,4010340
Waste And Scrap,March,2011,Q1,March 2011,959525682,968001775,8476093
Waste And Scrap,April,2011,Q2,April 2011,981250547,995297143,14046596
Waste And Scrap,May,2011,Q2,May 2011,972391838,983654799,11262961
Waste And Scrap,June,2011,Q2,June 2011,998129122,1005882937,7753815
Waste And Scrap,July,2011,Q3,July 2011,1052146874,1057754138,5607264
Waste And Scrap,August,2011,Q3,August 2011,1147713607,1166152158,18438551
Waste And Scrap,September,2011,Q3,September 2011,1026782525,1039628540,12846015
Waste And Scrap,October,2011,Q4,October 2011,992591985,998256211,5664226
Waste And Scrap,November,2011,Q4,November 2011,932351662,941347917,8996255
Waste And Scrap,December,2011,Q4,December 2011,820798029,834564573,13766544
Waste And Scrap,January,2012,Q1,January 2012,776214439,786338071,10123632
Waste And Scrap,February,2012,Q1,February 2012,864856457,874848551,9992094
Waste And Scrap,March,2012,Q1,March 2012,920190610,938533778,18343168
Waste And Scrap,April,2012,Q2,April 2012,804901760,815743023,10841263
Waste And Scrap,May,2012,Q2,May 2012,781567882,804145548,22577666
Waste And Scrap,June,2012,Q2,June 2012,706075521,718712531,12637010
Waste And Scrap,July,2012,Q3,July 2012,771709732,782917692,11207960
Waste And Scrap,August,2012,Q3,August 2012,750690216,761981178,11290962
Waste And Scrap,September,2012,Q3,September 2012,708943027,717930307,8987280
Waste And Scrap,October,2012,Q4,October 2012,776300317,794750795,18450478
Waste And Scrap,November,2012,Q4,November 2012,725839205,734368143,8528938
Waste And Scrap,December,2012,Q4,December 2012,784349773,795118399,10768626
Waste And Scrap,January,2013,Q1,January 2013,686159579,710520866,24361287
Waste And Scrap,February,2013,Q1,February 2013,793838797,800082774,6243977
Waste And Scrap,March,2013,Q1,March 2013,729865670,740386674,10521004
Waste And Scrap,April,2013,Q2,April 2013,648290928,658734938,10444010
Waste And Scrap,May,2013,Q2,May 2013,734958929,744245227,9286298
Waste And Scrap,June,2013,Q2,June 2013,681858468,689512880,7654412
Waste And Scrap,July,2013,Q3,July 2013,707024748,717009159,9984411
Waste And Scrap,August,2013,Q3,August 2013,782321810,787263692,4941882
Waste And Scrap,September,2013,Q3,September 2013,703634034,714235331,10601297
Waste And Scrap,October,2013,Q4,October 2013,766660634,782438860,15778226
Waste And Scrap,November,2013,Q4,November 2013,759218418,767740023,8521605
Waste And Scrap,December,2013,Q4,December 2013,639681145,650167472,10486327
Waste And Scrap,January,2014,Q1,January 2014,588118735,607615426,19496691
Waste And Scrap,February,2014,Q1,February 2014,550952770,560696273,9743503
Waste And Scrap,March,2014,Q1,March 2014,578838226,587485980,8647754
Waste And Scrap,April,2014,Q2,April 2014,530592450,538087794,7495344
Waste And Scrap,May,2014,Q2,May 2014,578783701,590750067,11966366
Waste And Scrap,June,2014,Q2,June 2014,576760809,589037976,12277167
Waste And Scrap,July,2014,Q3,July 2014,609889076,618223251,8334175
Waste And Scrap,August,2014,Q3,August 2014,673067634,679161025,6093391
Waste And Scrap,September,2014,Q3,September 2014,589010043,597128676,8118633
Waste And Scrap,October,2014,Q4,October 2014,607901345,616778812,8877467
Waste And Scrap,November,2014,Q4,November 2014,546696883,569722011,23025128
Waste And Scrap,December,2014,Q4,December 2014,550523805,563723811,13200006
Waste And Scrap,January,2015,Q1,January 2015,435172872,442940551,7767679
Waste And Scrap,February,2015,Q1,February 2015,411971451,423366630,11395179
Waste And Scrap,March,2015,Q1,March 2015,495786858,501571043,5784185
Waste And Scrap,April,2015,Q2,April 2015,548711630,554723355,6011725
Waste And Scrap,May,2015,Q2,May 2015,582271884,587805720,5533836
Waste And Scrap,June,2015,Q2,June 2015,577615918,585136782,7520864
Waste And Scrap,July,2015,Q3,July 2015,564003327,570413963,6410636
Waste And Scrap,August,2015,Q3,August 2015,506305338,520160195,13854857
Waste And Scrap,September,2015,Q3,September 2015,465769179,481779168,16009989
Waste And Scrap,October,2015,Q4,October 2015,463849348,473786473,9937125
Waste And Scrap,November,2015,Q4,November 2015,447402640,456098920,8696280
Waste And Scrap,December,2015,Q4,December 2015,371832607,379999873,8167266
Waste And Scrap,January,2016,Q1,January 2016,350825717,356147404,5321687
Waste And Scrap,February,2016,Q1,February 2016,353992020,359486960,5494940
Waste And Scrap,March,2016,Q1,March 2016,374249952,377575828,3325876
Waste And Scrap,April,2016,Q2,April 2016,414438903,420865911,6427008
Waste And Scrap,May,2016,Q2,May 2016,447557846,455149931,7592085
Waste And Scrap,June,2016,Q2,June 2016,420807106,425147866,4340760
Waste And Scrap,July,2016,Q3,July 2016,419750569,436228229,16477660
Waste And Scrap,August,2016,Q3,August 2016,445604740,458161227,12556487
Waste And Scrap,September,2016,Q3,September 2016,418431227,429166578,10735351
Waste And Scrap,October,2016,Q4,October 2016,473798303,480823024,7024721
Waste And Scrap,November,2016,Q4,November 2016,464553821,470320430,5766609
Waste And Scrap,December,2016,Q4,December 2016,499833519,511937661,12104142
Waste And Scrap,January,2017,Q1,January 2017,479335811,488498812,9163001
Waste And Scrap,February,2017,Q1,February 2017,441970814,455663601,13692787
Waste And Scrap,March,2017,Q1,March 2017,525552477,542022105,16469628
Waste And Scrap,April,2017,Q2,April 2017,461092222,469685662,8593440
Waste And Scrap,May,2017,Q2,May 2017,458529829,469134269,10604440
Waste And Scrap,June,2017,Q2,June 2017,439784464,451182378,11397914
Waste And Scrap,July,2017,Q3,July 2017,471151185,481585474,10434289
Waste And Scrap,August,2017,Q3,August 2017,472332012,489115857,16783845
Waste And Scrap,September,2017,Q3,September 2017,442807094,450938314,8131220
Waste And Scrap,October,2017,Q4,October 2017,426221870,440170049,13948179
Waste And Scrap,November,2017,Q4,November 2017,437499007,445992948,8493941
Waste And Scrap,December,2017,Q4,December 2017,449385129,459568029,10182900
Waste And Scrap,January,2018,Q1,January 2018,370521101,391910849,21389748
Waste And Scrap,February,2018,Q1,February 2018,404134062,417306636,13172574
Waste And Scrap,March,2018,Q1,March 2018,396860368,410593664,13733296
Waste And Scrap,April,2018,Q2,April 2018,428940089,439460585,10520496
Waste And Scrap,May,2018,Q2,May 2018,249379882,261943639,12563757
Waste And Scrap,June,2018,Q2,June 2018,238245925,250923987,12678062
Waste And Scrap,July,2018,Q3,July 2018,236834388,249034290,12199902
Waste And Scrap,August,2018,Q3,August 2018,202365278,215407073,13041795
Waste And Scrap,September,2018,Q3,September 2018,182085234,192364571,10279337
Waste And Scrap,October,2018,Q4,October 2018,197710578,206481779,8771201
Waste And Scrap,November,2018,Q4,November 2018,208587469,213848783,5261314
Waste And Scrap,December,2018,Q4,December 2018,182830816,189617033,6786217
Waste And Scrap,January,2019,Q1,January 2019,165841447,169422267,3580820
Waste And Scrap,February,2019,Q1,February 2019,161730672,165396925,3666253
Waste And Scrap,March,2019,Q1,March 2019,186510419,190252590,3742171
Waste And Scrap,April,2019,Q2,April 2019,205043512,211206406,6162894
Waste And Scrap,May,2019,Q2,May 2019,176681544,184089159,7407615
Waste And Scrap,June,2019,Q2,June 2019,154923382,161592250,6668868
Waste And Scrap,July,2019,Q3,July 2019,152507751,160445815,7938064
Waste And Scrap,August,2019,Q3,August 2019,127767276,136367236,8599960
Waste And Scrap,September,2019,Q3,September 2019,108872901,117510394,8637493
Waste And Scrap,October,2019,Q4,October 2019,99622183,107013229,7391046
Waste And Scrap,November,2019,Q4,November 2019,58765613,64150053,5384440
Waste And Scrap,December,2019,Q4,December 2019,-41688874,57471016,99159890
Used Or Second-hand Merchandise,January,2002,Q1,January 2002,-19659554,1425951,21085505
Used Or Second-hand Merchandise,February,2002,Q1,February 2002,-6026288,2815067,8841355
Used Or Second-hand Merchandise,March,2002,Q1,March 2002,-23385243,1123955,24509198
Used Or Second-hand Merchandise,April,2002,Q2,April 2002,-7057791,207278,7265069
Used Or Second-hand Merchandise,May,2002,Q2,May 2002,-7962514,1098380,9060894
Used Or Second-hand Merchandise,June,2002,Q2,June 2002,-19551667,101391,19653058
Used Or Second-hand Merchandise,July,2002,Q3,July 2002,-12996446,6488941,19485387
Used Or Second-hand Merchandise,August,2002,Q3,August 2002,-10511176,538312,11049488
Used Or Second-hand Merchandise,September,2002,Q3,September 2002,-17330961,699877,18030838
Used Or Second-hand Merchandise,October,2002,Q4,October 2002,-11502428,800514,12302942
Used Or Second-hand Merchandise,November,2002,Q4,November 2002,-7520296,693160,8213456
Used Or Second-hand Merchandise,December,2002,Q4,December 2002,-6622846,10855736,17478582
Used Or Second-hand Merchandise,January,2003,Q1,January 2003,-15604394,59229,15663623
Used Or Second-hand Merchandise,February,2003,Q1,February 2003,-9321600,222526,9544126
Used Or Second-hand Merchandise,March,2003,Q1,March 2003,-34356948,533672,34890620
Used Or Second-hand Merchandise,April,2003,Q2,April 2003,-8383702,711815,9095517
Used Or Second-hand Merchandise,May,2003,Q2,May 2003,-4767936,2312847,7080783
Used Or Second-hand Merchandise,June,2003,Q2,June 2003,-13130207,528953,13659160
Used Or Second-hand Merchandise,July,2003,Q3,July 2003,-13073210,2707787,15780997
Used Or Second-hand Merchandise,August,2003,Q3,August 2003,-13940725,217500,14158225
Used Or Second-hand Merchandise,September,2003,Q3,September 2003,-9138085,245674,9383759
Used Or Second-hand Merchandise,October,2003,Q4,October 2003,-12139076,1122347,13261423
Used Or Second-hand Merchandise,November,2003,Q4,November 2003,-8305030,92684,8397714
Used Or Second-hand Merchandise,December,2003,Q4,December 2003,-21623523,856282,22479805
Used Or Second-hand Merchandise,January,2004,Q1,January 2004,-15804150,369917,16174067
Used Or Second-hand Merchandise,February,2004,Q1,February 2004,-8278746,83983,8362729
Used Or Second-hand Merchandise,March,2004,Q1,March 2004,-29823493,178370,30001863
Used Or Second-hand Merchandise,April,2004,Q2,April 2004,-5938717,1885056,7823773
Used Or Second-hand Merchandise,May,2004,Q2,May 2004,-12847744,909278,13757022
Used Or Second-hand Merchandise,June,2004,Q2,June 2004,-12292673,2744562,15037235
Used Or Second-hand Merchandise,July,2004,Q3,July 2004,-22401206,1196452,23597658
Used Or Second-hand Merchandise,August,2004,Q3,August 2004,-5491285,3535835,9027120
Used Or Second-hand Merchandise,September,2004,Q3,September 2004,-8238355,448329,8686684
Used Or Second-hand Merchandise,October,2004,Q4,October 2004,-14175840,990197,15166037
Used Or Second-hand Merchandise,November,2004,Q4,November 2004,-11871508,40615,11912123
Used Or Second-hand Merchandise,December,2004,Q4,December 2004,-12882602,4964602,17847204
Used Or Second-hand Merchandise,January,2005,Q1,January 2005,-20350108,8860,20358968
Used Or Second-hand Merchandise,February,2005,Q1,February 2005,-17678206,4807073,22485279
Used Or Second-hand Merchandise,March,2005,Q1,March 2005,-41404896,301647,41706543
Used Or Second-hand Merchandise,April,2005,Q2,April 2005,-47255070,854589,48109659
Used Or Second-hand Merchandise,May,2005,Q2,May 2005,-8875793,405354,9281147
Used Or Second-hand Merchandise,June,2005,Q2,June 2005,-19936453,876543,20812996
Used Or Second-hand Merchandise,July,2005,Q3,July 2005,-21695323,600970,22296293
Used Or Second-hand Merchandise,August,2005,Q3,August 2005,-15491695,321733,15813428
Used Or Second-hand Merchandise,September,2005,Q3,September 2005,-13563827,1157824,14721651
Used Or Second-hand Merchandise,October,2005,Q4,October 2005,-17508039,1239543,18747582
Used Or Second-hand Merchandise,November,2005,Q4,November 2005,-19090346,2332064,21422410
Used Or Second-hand Merchandise,December,2005,Q4,December 2005,-26748569,1379405,28127974
Used Or Second-hand Merchandise,January,2006,Q1,January 2006,-33942159,434184,34376343
Used Or Second-hand Merchandise,February,2006,Q1,February 2006,-12273382,2154363,14427745
Used Or Second-hand Merchandise,March,2006,Q1,March 2006,-43122871,386193,43509064
Used Or Second-hand Merchandise,April,2006,Q2,April 2006,-13594613,326408,13921021
Used Or Second-hand Merchandise,May,2006,Q2,May 2006,-2544690,12211183,14755873
Used Or Second-hand Merchandise,June,2006,Q2,June 2006,-28451972,629426,29081398
Used Or Second-hand Merchandise,July,2006,Q3,July 2006,-22442178,1016390,23458568
Used Or Second-hand Merchandise,August,2006,Q3,August 2006,-13648629,2186703,15835332
Used Or Second-hand Merchandise,September,2006,Q3,September 2006,-13135095,828000,13963095
Used Or Second-hand Merchandise,October,2006,Q4,October 2006,-19285992,1676692,20962684
Used Or Second-hand Merchandise,November,2006,Q4,November 2006,-26492958,960591,27453549
Used Or Second-hand Merchandise,December,2006,Q4,December 2006,-36237219,1034714,37271933
Used Or Second-hand Merchandise,January,2007,Q1,January 2007,-29669395,509860,30179255
Used Or Second-hand Merchandise,February,2007,Q1,February 2007,-14816615,1641248,16457863
Used Or Second-hand Merchandise,March,2007,Q1,March 2007,-86262551,1525671,87788222
Used Or Second-hand Merchandise,April,2007,Q2,April 2007,-9402722,2419251,11821973
Used Or Second-hand Merchandise,May,2007,Q2,May 2007,-17149038,2104834,19253872
Used Or Second-hand Merchandise,June,2007,Q2,June 2007,-36632264,863325,37495589
Used Or Second-hand Merchandise,July,2007,Q3,July 2007,-32201520,185190,32386710
Used Or Second-hand Merchandise,August,2007,Q3,August 2007,-12311700,9922233,22233933
Used Or Second-hand Merchandise,September,2007,Q3,September 2007,-52666905,1494053,54160958
Used Or Second-hand Merchandise,October,2007,Q4,October 2007,-21525055,3880418,25405473
Used Or Second-hand Merchandise,November,2007,Q4,November 2007,-12446691,4764646,17211337
Used Or Second-hand Merchandise,December,2007,Q4,December 2007,-26915050,5292589,32207639
Used Or Second-hand Merchandise,January,2008,Q1,January 2008,-38288301,537219,38825520
Used Or Second-hand Merchandise,February,2008,Q1,February 2008,-22998465,764570,23763035
Used Or Second-hand Merchandise,March,2008,Q1,March 2008,-57362263,2052283,59414546
Used Or Second-hand Merchandise,April,2008,Q2,April 2008,-13717467,3442700,17160167
Used Or Second-hand Merchandise,May,2008,Q2,May 2008,-29322398,2757635,32080033
Used Or Second-hand Merchandise,June,2008,Q2,June 2008,-28741941,966375,29708316
Used Or Second-hand Merchandise,July,2008,Q3,July 2008,-2264439,37079714,39344153
Used Or Second-hand Merchandise,August,2008,Q3,August 2008,-18633719,7797143,26430862
Used Or Second-hand Merchandise,September,2008,Q3,September 2008,-21078905,7566520,28645425
Used Or Second-hand Merchandise,October,2008,Q4,October 2008,-27954580,1902367,29856947
Used Or Second-hand Merchandise,November,2008,Q4,November 2008,-5064954,5990742,11055696
Used Or Second-hand Merchandise,December,2008,Q4,December 2008,-15154563,5052367,20206930
Used Or Second-hand Merchandise,January,2009,Q1,January 2009,-14935079,945856,15880935
Used Or Second-hand Merchandise,February,2009,Q1,February 2009,-6208165,3298392,9506557
Used Or Second-hand Merchandise,March,2009,Q1,March 2009,-20435956,3122162,23558118
Used Or Second-hand Merchandise,April,2009,Q2,April 2009,-18817014,2531131,21348145
Used Or Second-hand Merchandise,May,2009,Q2,May 2009,-946601,10903989,11850590
Used Or Second-hand Merchandise,June,2009,Q2,June 2009,-11734251,2553405,14287656
Used Or Second-hand Merchandise,July,2009,Q3,July 2009,-15275450,6289933,21565383
Used Or Second-hand Merchandise,August,2009,Q3,August 2009,-241205,4822061,5063266
Used Or Second-hand Merchandise,September,2009,Q3,September 2009,-7936501,3637467,11573968
Used Or Second-hand Merchandise,October,2009,Q4,October 2009,-12131670,2404748,14536418
Used Or Second-hand Merchandise,November,2009,Q4,November 2009,742639,5935956,5193317
Used Or Second-hand Merchandise,December,2009,Q4,December 2009,-27206384,3129198,30335582
Used Or Second-hand Merchandise,January,2010,Q1,January 2010,-24420939,1585601,26006540
Used Or Second-hand Merchandise,February,2010,Q1,February 2010,-17969253,2416325,20385578
Used Or Second-hand Merchandise,March,2010,Q1,March 2010,-24023165,9190092,33213257
Used Or Second-hand Merchandise,April,2010,Q2,April 2010,-10889817,2535358,13425175
Used Or Second-hand Merchandise,May,2010,Q2,May 2010,-20306766,2807380,23114146
Used Or Second-hand Merchandise,June,2010,Q2,June 2010,-13390248,1733180,15123428
Used Or Second-hand Merchandise,July,2010,Q3,July 2010,-31014100,2454163,33468263
Used Or Second-hand Merchandise,August,2010,Q3,August 2010,-8069224,3103486,11172710
Used Or Second-hand Merchandise,September,2010,Q3,September 2010,-13690959,6629956,20320915
Used Or Second-hand Merchandise,October,2010,Q4,October 2010,-10116821,4602348,14719169
Used Or Second-hand Merchandise,November,2010,Q4,November 2010,-19564432,4665785,24230217
Used Or Second-hand Merchandise,December,2010,Q4,December 2010,-16140015,2680945,18820960
Used Or Second-hand Merchandise,January,2011,Q1,January 2011,-17374481,2457725,19832206
Used Or Second-hand Merchandise,February,2011,Q1,February 2011,-19975242,2576045,22551287
Used Or Second-hand Merchandise,March,2011,Q1,March 2011,-16338007,3607162,19945169
Used Or Second-hand Merchandise,April,2011,Q2,April 2011,-8082487,9428412,17510899
Used Or Second-hand Merchandise,May,2011,Q2,May 2011,-9735060,29656450,39391510
Used Or Second-hand Merchandise,June,2011,Q2,June 2011,-42193125,4620599,46813724
Used Or Second-hand Merchandise,July,2011,Q3,July 2011,-28566660,3955532,32522192
Used Or Second-hand Merchandise,August,2011,Q3,August 2011,-16200883,2667160,18868043
Used Or Second-hand Merchandise,September,2011,Q3,September 2011,-10429740,1842738,12272478
Used Or Second-hand Merchandise,October,2011,Q4,October 2011,-11942368,6879857,18822225
Used Or Second-hand Merchandise,November,2011,Q4,November 2011,-18976525,3625594,22602119
Used Or Second-hand Merchandise,December,2011,Q4,December 2011,-29647069,2566025,32213094
Used Or Second-hand Merchandise,January,2012,Q1,January 2012,46124627,92062251,45937624
Used Or Second-hand Merchandise,February,2012,Q1,February 2012,50366123,77094144,26728021
Used Or Second-hand Merchandise,March,2012,Q1,March 2012,57859488,82503785,24644297
Used Or Second-hand Merchandise,April,2012,Q2,April 2012,54192934,65383818,11190884
Used Or Second-hand Merchandise,May,2012,Q2,May 2012,49559462,69098933,19539471
Used Or Second-hand Merchandise,June,2012,Q2,June 2012,30564708,57126796,26562088
Used Or Second-hand Merchandise,July,2012,Q3,July 2012,26381072,52427818,26046746
Used Or Second-hand Merchandise,August,2012,Q3,August 2012,27260752,55920494,28659742
Used Or Second-hand Merchandise,September,2012,Q3,September 2012,21656908,43714522,22057614
Used Or Second-hand Merchandise,October,2012,Q4,October 2012,24109331,51471214,27361883
Used Or Second-hand Merchandise,November,2012,Q4,November 2012,-3255317,65660482,68915799
Used Or Second-hand Merchandise,December,2012,Q4,December 2012,36021021,62473437,26452416
Used Or Second-hand Merchandise,January,2013,Q1,January 2013,16077967,61331913,45253946
Used Or Second-hand Merchandise,February,2013,Q1,February 2013,34096026,70740614,36644588
Used Or Second-hand Merchandise,March,2013,Q1,March 2013,74140313,93791965,19651652
Used Or Second-hand Merchandise,April,2013,Q2,April 2013,85127895,105928505,20800610
Used Or Second-hand Merchandise,May,2013,Q2,May 2013,83492985,101255693,17762708
Used Or Second-hand Merchandise,June,2013,Q2,June 2013,49143379,73468135,24324756
Used Or Second-hand Merchandise,July,2013,Q3,July 2013,36263010,73074961,36811951
Used Or Second-hand Merchandise,August,2013,Q3,August 2013,68625488,81006425,12380937
Used Or Second-hand Merchandise,September,2013,Q3,September 2013,167043,62465665,62298622
Used Or Second-hand Merchandise,October,2013,Q4,October 2013,70331907,81939673,11607766
Used Or Second-hand Merchandise,November,2013,Q4,November 2013,65754359,85089197,19334838
Used Or Second-hand Merchandise,December,2013,Q4,December 2013,77700398,112867497,35167099
Used Or Second-hand Merchandise,January,2014,Q1,January 2014,54446276,96578368,42132092
Used Or Second-hand Merchandise,February,2014,Q1,February 2014,68429924,89797581,21367657
Used Or Second-hand Merchandise,March,2014,Q1,March 2014,96680591,115515626,18835035
Used Or Second-hand Merchandise,April,2014,Q2,April 2014,82005831,116692156,34686325
Used Or Second-hand Merchandise,May,2014,Q2,May 2014,155086093,172375900,17289807
Used Or Second-hand Merchandise,June,2014,Q2,June 2014,87384468,116473581,29089113
Used Or Second-hand Merchandise,July,2014,Q3,July 2014,63948855,113228908,49280053
Used Or Second-hand Merchandise,August,2014,Q3,August 2014,96918572,122518388,25599816
Used Or Second-hand Merchandise,September,2014,Q3,September 2014,82013117,132359769,50346652
Used Or Second-hand Merchandise,October,2014,Q4,October 2014,64981241,77300236,12318995
Used Or Second-hand Merchandise,November,2014,Q4,November 2014,58136860,73156924,15020064
Used Or Second-hand Merchandise,December,2014,Q4,December 2014,41000565,58527757,17527192
Used Or Second-hand Merchandise,January,2015,Q1,January 2015,-60240917,51972210,112213127
Used Or Second-hand Merchandise,February,2015,Q1,February 2015,41020954,71453176,30432222
Used Or Second-hand Merchandise,March,2015,Q1,March 2015,56748009,82947845,26199836
Used Or Second-hand Merchandise,April,2015,Q2,April 2015,54659172,74728773,20069601
Used Or Second-hand Merchandise,May,2015,Q2,May 2015,73109824,84122767,11012943
Used Or Second-hand Merchandise,June,2015,Q2,June 2015,52940431,90028973,37088542
Used Or Second-hand Merchandise,July,2015,Q3,July 2015,53205737,84161123,30955386
Used Or Second-hand Merchandise,August,2015,Q3,August 2015,39776865,68249203,28472338
Used Or Second-hand Merchandise,September,2015,Q3,September 2015,38635089,70640051,32004962
Used Or Second-hand Merchandise,October,2015,Q4,October 2015,34592690,62692286,28099596
Used Or Second-hand Merchandise,November,2015,Q4,November 2015,46751282,70280457,23529175
Used Or Second-hand Merchandise,December,2015,Q4,December 2015,32794742,62174812,29380070
Used Or Second-hand Merchandise,January,2016,Q1,January 2016,2286095,25983237,23697142
Used Or Second-hand Merchandise,February,2016,Q1,February 2016,10039318,32900749,22861431
Used Or Second-hand Merchandise,March,2016,Q1,March 2016,37893055,57280187,19387132
Used Or Second-hand Merchandise,April,2016,Q2,April 2016,15707408,39939549,24232141
Used Or Second-hand Merchandise,May,2016,Q2,May 2016,40904673,57577293,16672620
Used Or Second-hand Merchandise,June,2016,Q2,June 2016,20160735,56475969,36315234
Used Or Second-hand Merchandise,July,2016,Q3,July 2016,41308723,86670378,45361655
Used Or Second-hand Merchandise,August,2016,Q3,August 2016,13049387,64633093,51583706
Used Or Second-hand Merchandise,September,2016,Q3,September 2016,35746087,53059653,17313566
Used Or Second-hand Merchandise,October,2016,Q4,October 2016,61888052,88223546,26335494
Used Or Second-hand Merchandise,November,2016,Q4,November 2016,52374651,66495490,14120839
Used Or Second-hand Merchandise,December,2016,Q4,December 2016,37372108,75994992,38622884
Used Or Second-hand Merchandise,January,2017,Q1,January 2017,30720721,57846181,27125460
Used Or Second-hand Merchandise,February,2017,Q1,February 2017,30696034,56595537,25899503
Used Or Second-hand Merchandise,March,2017,Q1,March 2017,38191485,64737382,26545897
Used Or Second-hand Merchandise,April,2017,Q2,April 2017,45176227,68014078,22837851
Used Or Second-hand Merchandise,May,2017,Q2,May 2017,49315445,70720002,21404557
Used Or Second-hand Merchandise,June,2017,Q2,June 2017,37777875,60561715,22783840
Used Or Second-hand Merchandise,July,2017,Q3,July 2017,47443564,67361109,19917545
Used Or Second-hand Merchandise,August,2017,Q3,August 2017,41768733,56819116,15050383
Used Or Second-hand Merchandise,September,2017,Q3,September 2017,38785982,63303308,24517326
Used Or Second-hand Merchandise,October,2017,Q4,October 2017,38962638,77111021,38148383
Used Or Second-hand Merchandise,November,2017,Q4,November 2017,48235335,73101921,24866586
Used Or Second-hand Merchandise,December,2017,Q4,December 2017,58166103,83504534,25338431
Used Or Second-hand Merchandise,January,2018,Q1,January 2018,40207870,69356357,29148487
Used Or Second-hand Merchandise,February,2018,Q1,February 2018,42380146,60054199,17674053
Used Or Second-hand Merchandise,March,2018,Q1,March 2018,56117960,77329933,21211973
Used Or Second-hand Merchandise,April,2018,Q2,April 2018,61647868,81503800,19855932
Used Or Second-hand Merchandise,May,2018,Q2,May 2018,45589569,67449147,21859578
Used Or Second-hand Merchandise,June,2018,Q2,June 2018,26192566,54713410,28520844
Used Or Second-hand Merchandise,July,2018,Q3,July 2018,11475119,46318300,34843181
Used Or Second-hand Merchandise,August,2018,Q3,August 2018,10448455,38011056,27562601
Used Or Second-hand Merchandise,September,2018,Q3,September 2018,3482366,34431566,30949200
Used Or Second-hand Merchandise,October,2018,Q4,October 2018,38255728,65741206,27485478
Used Or Second-hand Merchandise,November,2018,Q4,November 2018,15466077,35325316,19859239
Used Or Second-hand Merchandise,December,2018,Q4,December 2018,18654505,40160735,21506230
Used Or Second-hand Merchandise,January,2019,Q1,January 2019,-51964186,35879469,87843655
Used Or Second-hand Merchandise,February,2019,Q1,February 2019,16673453,43730516,27057063
Used Or Second-hand Merchandise,March,2019,Q1,March 2019,27675303,48014104,20338801
Used Or Second-hand Merchandise,April,2019,Q2,April 2019,50254027,64730106,14476079
Used Or Second-hand Merchandise,May,2019,Q2,May 2019,44914158,69866812,24952654
Used Or Second-hand Merchandise,June,2019,Q2,June 2019,18776490,49218470,30441980
Used Or Second-hand Merchandise,July,2019,Q3,July 2019,14807263,32641982,17834719
Used Or Second-hand Merchandise,August,2019,Q3,August 2019,-36209575,39527591,75737166
Used Or Second-hand Merchandise,September,2019,Q3,September 2019,19981922,28569064,8587142
Used Or Second-hand Merchandise,October,2019,Q4,October 2019,72066773,80875662,8808889
Used Or Second-hand Merchandise,November,2019,Q4,November 2019,29714682,36522848,6808166
Used Or Second-hand Merchandise,December,2019,Q4,December 2019,94560832,103132509,8571677
Goods Returned (exports For Canada Only),January,2002,Q1,January 2002,-27305899,,27305899
Goods Returned (exports For Canada Only),February,2002,Q1,February 2002,-21191305,,21191305
Goods Returned (exports For Canada Only),March,2002,Q1,March 2002,-27788288,,27788288
Goods Returned (exports For Canada Only),April,2002,Q2,April 2002,-28001424,,28001424
Goods Returned (exports For Canada Only),May,2002,Q2,May 2002,-29265528,,29265528
Goods Returned (exports For Canada Only),June,2002,Q2,June 2002,-38284235,,38284235
Goods Returned (exports For Canada Only),July,2002,Q3,July 2002,-35232552,,35232552
Goods Returned (exports For Canada Only),August,2002,Q3,August 2002,-35096146,,35096146
Goods Returned (exports For Canada Only),September,2002,Q3,September 2002,-39642397,,39642397
Goods Returned (exports For Canada Only),October,2002,Q4,October 2002,-33856112,,33856112
Goods Returned (exports For Canada Only),November,2002,Q4,November 2002,-25873395,,25873395
Goods Returned (exports For Canada Only),December,2002,Q4,December 2002,-38634535,,38634535
Goods Returned (exports For Canada Only),January,2003,Q1,January 2003,-47807008,,47807008
Goods Returned (exports For Canada Only),February,2003,Q1,February 2003,-34480415,,34480415
Goods Returned (exports For Canada Only),March,2003,Q1,March 2003,-35307736,,35307736
Goods Returned (exports For Canada Only),April,2003,Q2,April 2003,-38947548,,38947548
Goods Returned (exports For Canada Only),May,2003,Q2,May 2003,-35594148,,35594148
Goods Returned (exports For Canada Only),June,2003,Q2,June 2003,-40678798,,40678798
Goods Returned (exports For Canada Only),July,2003,Q3,July 2003,-37314650,,37314650
Goods Returned (exports For Canada Only),August,2003,Q3,August 2003,-35664871,,35664871
Goods Returned (exports For Canada Only),September,2003,Q3,September 2003,-36261227,,36261227
Goods Returned (exports For Canada Only),October,2003,Q4,October 2003,-37438952,,37438952
Goods Returned (exports For Canada Only),November,2003,Q4,November 2003,-43795931,,43795931
Goods Returned (exports For Canada Only),December,2003,Q4,December 2003,-50632362,,50632362
Goods Returned (exports For Canada Only),January,2004,Q1,January 2004,-42882923,,42882923
Goods Returned (exports For Canada Only),February,2004,Q1,February 2004,-40420895,,40420895
Goods Returned (exports For Canada Only),March,2004,Q1,March 2004,-46659467,,46659467
Goods Returned (exports For Canada Only),April,2004,Q2,April 2004,-47125523,,47125523
Goods Returned (exports For Canada Only),May,2004,Q2,May 2004,-55380081,,55380081
Goods Returned (exports For Canada Only),June,2004,Q2,June 2004,-51754932,,51754932
Goods Returned (exports For Canada Only),July,2004,Q3,July 2004,-48510203,,48510203
Goods Returned (exports For Canada Only),August,2004,Q3,August 2004,-56700082,,56700082
Goods Returned (exports For Canada Only),September,2004,Q3,September 2004,-52928171,,52928171
Goods Returned (exports For Canada Only),October,2004,Q4,October 2004,-47559778,,47559778
Goods Returned (exports For Canada Only),November,2004,Q4,November 2004,-57613123,,57613123
Goods Returned (exports For Canada Only),December,2004,Q4,December 2004,-48725858,,48725858
Goods Returned (exports For Canada Only),January,2005,Q1,January 2005,-38672189,,38672189
Goods Returned (exports For Canada Only),February,2005,Q1,February 2005,-61397363,,61397363
Goods Returned (exports For Canada Only),March,2005,Q1,March 2005,-46394235,,46394235
Goods Returned (exports For Canada Only),April,2005,Q2,April 2005,-50131096,,50131096
Goods Returned (exports For Canada Only),May,2005,Q2,May 2005,-56775025,,56775025
Goods Returned (exports For Canada Only),June,2005,Q2,June 2005,-56660544,,56660544
Goods Returned (exports For Canada Only),July,2005,Q3,July 2005,-68425706,,68425706
Goods Returned (exports For Canada Only),August,2005,Q3,August 2005,-47819602,,47819602
Goods Returned (exports For Canada Only),September,2005,Q3,September 2005,-91777437,,91777437
Goods Returned (exports For Canada Only),October,2005,Q4,October 2005,-63550336,,63550336
Goods Returned (exports For Canada Only),November,2005,Q4,November 2005,-59422878,,59422878
Goods Returned (exports For Canada Only),December,2005,Q4,December 2005,-51243613,,51243613
Goods Returned (exports For Canada Only),January,2006,Q1,January 2006,-80465463,,80465463
Goods Returned (exports For Canada Only),February,2006,Q1,February 2006,-59264075,,59264075
Goods Returned (exports For Canada Only),March,2006,Q1,March 2006,-60340434,,60340434
Goods Returned (exports For Canada Only),April,2006,Q2,April 2006,-65071405,,65071405
Goods Returned (exports For Canada Only),May,2006,Q2,May 2006,-62282868,,62282868
Goods Returned (exports For Canada Only),June,2006,Q2,June 2006,-68510612,,68510612
Goods Returned (exports For Canada Only),July,2006,Q3,July 2006,-56286314,,56286314
Goods Returned (exports For Canada Only),August,2006,Q3,August 2006,-70733770,,70733770
Goods Returned (exports For Canada Only),September,2006,Q3,September 2006,-60245806,,60245806
Goods Returned (exports For Canada Only),October,2006,Q4,October 2006,-61351929,,61351929
Goods Returned (exports For Canada Only),November,2006,Q4,November 2006,-88532917,,88532917
Goods Returned (exports For Canada Only),December,2006,Q4,December 2006,-69281601,,69281601
Goods Returned (exports For Canada Only),January,2007,Q1,January 2007,-72810786,,72810786
Goods Returned (exports For Canada Only),February,2007,Q1,February 2007,-77000936,,77000936
Goods Returned (exports For Canada Only),March,2007,Q1,March 2007,-64907548,,64907548
Goods Returned (exports For Canada Only),April,2007,Q2,April 2007,-72731162,,72731162
Goods Returned (exports For Canada Only),May,2007,Q2,May 2007,-71168199,,71168199
Goods Returned (exports For Canada Only),June,2007,Q2,June 2007,-85853376,,85853376
Goods Returned (exports For Canada Only),July,2007,Q3,July 2007,-99686695,,99686695
Goods Returned (exports For Canada Only),August,2007,Q3,August 2007,-79658543,,79658543
Goods Returned (exports For Canada Only),September,2007,Q3,September 2007,-66020427,,66020427
Goods Returned (exports For Canada Only),October,2007,Q4,October 2007,-108455853,,108455853
Goods Returned (exports For Canada Only),November,2007,Q4,November 2007,-98598798,,98598798
Goods Returned (exports For Canada Only),December,2007,Q4,December 2007,-69530988,,69530988
Goods Returned (exports For Canada Only),January,2008,Q1,January 2008,-84302367,,84302367
Goods Returned (exports For Canada Only),February,2008,Q1,February 2008,-50130259,,50130259
Goods Returned (exports For Canada Only),March,2008,Q1,March 2008,-75535536,,75535536
Goods Returned (exports For Canada Only),April,2008,Q2,April 2008,-80797948,,80797948
Goods Returned (exports For Canada Only),May,2008,Q2,May 2008,-62586495,,62586495
Goods Returned (exports For Canada Only),June,2008,Q2,June 2008,-72627409,,72627409
Goods Returned (exports For Canada Only),July,2008,Q3,July 2008,-108478497,,108478497
Goods Returned (exports For Canada Only),August,2008,Q3,August 2008,-73666320,,73666320
Goods Returned (exports For Canada Only),September,2008,Q3,September 2008,-76240136,,76240136
Goods Returned (exports For Canada Only),October,2008,Q4,October 2008,-87412199,,87412199
Goods Returned (exports For Canada Only),November,2008,Q4,November 2008,-99473743,,99473743
Goods Returned (exports For Canada Only),December,2008,Q4,December 2008,-110312929,,110312929
Goods Returned (exports For Canada Only),January,2009,Q1,January 2009,-68433353,,68433353
Goods Returned (exports For Canada Only),February,2009,Q1,February 2009,-119137478,,119137478
Goods Returned (exports For Canada Only),March,2009,Q1,March 2009,-107418271,,107418271
Goods Returned (exports For Canada Only),April,2009,Q2,April 2009,-82130543,,82130543
Goods Returned (exports For Canada Only),May,2009,Q2,May 2009,-91403050,,91403050
Goods Returned (exports For Canada Only),June,2009,Q2,June 2009,-100281928,,100281928
Goods Returned (exports For Canada Only),July,2009,Q3,July 2009,-72297562,,72297562
Goods Returned (exports For Canada Only),August,2009,Q3,August 2009,-70492875,,70492875
Goods Returned (exports For Canada Only),September,2009,Q3,September 2009,-77743315,,77743315
Goods Returned (exports For Canada Only),October,2009,Q4,October 2009,-72328159,,72328159
Goods Returned (exports For Canada Only),November,2009,Q4,November 2009,-71241605,,71241605
Goods Returned (exports For Canada Only),December,2009,Q4,December 2009,-85040539,,85040539
Goods Returned (exports For Canada Only),January,2010,Q1,January 2010,-70792817,,70792817
Goods Returned (exports For Canada Only),February,2010,Q1,February 2010,-75217532,,75217532
Goods Returned (exports For Canada Only),March,2010,Q1,March 2010,-106335609,,106335609
Goods Returned (exports For Canada Only),April,2010,Q2,April 2010,-149744138,,149744138
Goods Returned (exports For Canada Only),May,2010,Q2,May 2010,-71634307,,71634307
Goods Returned (exports For Canada Only),June,2010,Q2,June 2010,-95683246,,95683246
Goods Returned (exports For Canada Only),July,2010,Q3,July 2010,-85376004,,85376004
Goods Returned (exports For Canada Only),August,2010,Q3,August 2010,-91039670,,91039670
Goods Returned (exports For Canada Only),September,2010,Q3,September 2010,-85956636,,85956636
Goods Returned (exports For Canada Only),October,2010,Q4,October 2010,-96021053,,96021053
Goods Returned (exports For Canada Only),November,2010,Q4,November 2010,-97681497,,97681497
Goods Returned (exports For Canada Only),December,2010,Q4,December 2010,-101039169,,101039169
Goods Returned (exports For Canada Only),January,2011,Q1,January 2011,-112569671,,112569671
Goods Returned (exports For Canada Only),February,2011,Q1,February 2011,-89616767,,89616767
Goods Returned (exports For Canada Only),March,2011,Q1,March 2011,-106794831,,106794831
Goods Returned (exports For Canada Only),April,2011,Q2,April 2011,-101699356,,101699356
Goods Returned (exports For Canada Only),May,2011,Q2,May 2011,-97934923,,97934923
Goods Returned (exports For Canada Only),June,2011,Q2,June 2011,-80236562,,80236562
Goods Returned (exports For Canada Only),July,2011,Q3,July 2011,-86113906,,86113906
Goods Returned (exports For Canada Only),August,2011,Q3,August 2011,-126234441,,126234441
Goods Returned (exports For Canada Only),September,2011,Q3,September 2011,-87391993,,87391993
Goods Returned (exports For Canada Only),October,2011,Q4,October 2011,-98289956,,98289956
Goods Returned (exports For Canada Only),November,2011,Q4,November 2011,-114386576,,114386576
Goods Returned (exports For Canada Only),December,2011,Q4,December 2011,-121611565,,121611565
Goods Returned (exports For Canada Only),January,2012,Q1,January 2012,-102878598,,102878598
Goods Returned (exports For Canada Only),February,2012,Q1,February 2012,-81339735,,81339735
Goods Returned (exports For Canada Only),March,2012,Q1,March 2012,-117592276,,117592276
Goods Returned (exports For Canada Only),April,2012,Q2,April 2012,-91191172,,91191172
Goods Returned (exports For Canada Only),May,2012,Q2,May 2012,-100132811,,100132811
Goods Returned (exports For Canada Only),June,2012,Q2,June 2012,-110418530,,110418530
Goods Returned (exports For Canada Only),July,2012,Q3,July 2012,-129735868,,129735868
Goods Returned (exports For Canada Only),August,2012,Q3,August 2012,-282538162,,282538162
Goods Returned (exports For Canada Only),September,2012,Q3,September 2012,-110589692,,110589692
Goods Returned (exports For Canada Only),October,2012,Q4,October 2012,-249937634,,249937634
Goods Returned (exports For Canada Only),November,2012,Q4,November 2012,-141616487,,141616487
Goods Returned (exports For Canada Only),December,2012,Q4,December 2012,-116461716,,116461716
Goods Returned (exports For Canada Only),January,2013,Q1,January 2013,-139659069,,139659069
Goods Returned (exports For Canada Only),February,2013,Q1,February 2013,-130578216,,130578216
Goods Returned (exports For Canada Only),March,2013,Q1,March 2013,-127658537,,127658537
Goods Returned (exports For Canada Only),April,2013,Q2,April 2013,-153616888,,153616888
Goods Returned (exports For Canada Only),May,2013,Q2,May 2013,-222036019,,222036019
Goods Returned (exports For Canada Only),June,2013,Q2,June 2013,-116374024,,116374024
Goods Returned (exports For Canada Only),July,2013,Q3,July 2013,-180665323,,180665323
Goods Returned (exports For Canada Only),August,2013,Q3,August 2013,-156073615,,156073615
Goods Returned (exports For Canada Only),September,2013,Q3,September 2013,-131093218,,131093218
Goods Returned (exports For Canada Only),October,2013,Q4,October 2013,-147153033,,147153033
Goods Returned (exports For Canada Only),November,2013,Q4,November 2013,-115246461,,115246461
Goods Returned (exports For Canada Only),December,2013,Q4,December 2013,-160302248,,160302248
Goods Returned (exports For Canada Only),January,2014,Q1,January 2014,-146508000,,146508000
Goods Returned (exports For Canada Only),February,2014,Q1,February 2014,-104025407,,104025407
Goods Returned (exports For Canada Only),March,2014,Q1,March 2014,-160189133,,160189133
Goods Returned (exports For Canada Only),April,2014,Q2,April 2014,-147632656,,147632656
Goods Returned (exports For Canada Only),May,2014,Q2,May 2014,-180077342,,180077342
Goods Returned (exports For Canada Only),June,2014,Q2,June 2014,-199043863,,199043863
Goods Returned (exports For Canada Only),July,2014,Q3,July 2014,-182195962,,182195962
Goods Returned (exports For Canada Only),August,2014,Q3,August 2014,-143947067,,143947067
Goods Returned (exports For Canada Only),September,2014,Q3,September 2014,-163505730,,163505730
Goods Returned (exports For Canada Only),October,2014,Q4,October 2014,-113205942,,113205942
Goods Returned (exports For Canada Only),November,2014,Q4,November 2014,-154631222,,154631222
Goods Returned (exports For Canada Only),December,2014,Q4,December 2014,-277847563,,277847563
Goods Returned (exports For Canada Only),January,2015,Q1,January 2015,-156482331,,156482331
Goods Returned (exports For Canada Only),February,2015,Q1,February 2015,-147333975,,147333975
Goods Returned (exports For Canada Only),March,2015,Q1,March 2015,-173881265,,173881265
Goods Returned (exports For Canada Only),April,2015,Q2,April 2015,-201702243,,201702243
Goods Returned (exports For Canada Only),May,2015,Q2,May 2015,-154823949,,154823949
Goods Returned (exports For Canada Only),June,2015,Q2,June 2015,-174938299,,174938299
Goods Returned (exports For Canada Only),July,2015,Q3,July 2015,-167755465,,167755465
Goods Returned (exports For Canada Only),August,2015,Q3,August 2015,-206661036,,206661036
Goods Returned (exports For Canada Only),September,2015,Q3,September 2015,-178605917,,178605917
Goods Returned (exports For Canada Only),October,2015,Q4,October 2015,-127482510,,127482510
Goods Returned (exports For Canada Only),November,2015,Q4,November 2015,-148940624,,148940624
Goods Returned (exports For Canada Only),December,2015,Q4,December 2015,-203968135,,203968135
Goods Returned (exports For Canada Only),January,2016,Q1,January 2016,-159993358,,159993358
Goods Returned (exports For Canada Only),February,2016,Q1,February 2016,-144219488,,144219488
Goods Returned (exports For Canada Only),March,2016,Q1,March 2016,-145835566,,145835566
Goods Returned (exports For Canada Only),April,2016,Q2,April 2016,-159069665,,159069665
Goods Returned (exports For Canada Only),May,2016,Q2,May 2016,-146658840,,146658840
Goods Returned (exports For Canada Only),June,2016,Q2,June 2016,-138734794,,138734794
Goods Returned (exports For Canada Only),July,2016,Q3,July 2016,-172289840,,172289840
Goods Returned (exports For Canada Only),August,2016,Q3,August 2016,-170463959,,170463959
Goods Returned (exports For Canada Only),September,2016,Q3,September 2016,-291426930,,291426930
Goods Returned (exports For Canada Only),October,2016,Q4,October 2016,-182385242,,182385242
Goods Returned (exports For Canada Only),November,2016,Q4,November 2016,-155836471,,155836471
Goods Returned (exports For Canada Only),December,2016,Q4,December 2016,-179999934,,179999934
Goods Returned (exports For Canada Only),January,2017,Q1,January 2017,-170162648,,170162648
Goods Returned (exports For Canada Only),February,2017,Q1,February 2017,-170955462,,170955462
Goods Returned (exports For Canada Only),March,2017,Q1,March 2017,-236602487,,236602487
Goods Returned (exports For Canada Only),April,2017,Q2,April 2017,-210043319,,210043319
Goods Returned (exports For Canada Only),May,2017,Q2,May 2017,-175094826,,175094826
Goods Returned (exports For Canada Only),June,2017,Q2,June 2017,-190902868,,190902868
Goods Returned (exports For Canada Only),July,2017,Q3,July 2017,-226788772,,226788772
Goods Returned (exports For Canada Only),August,2017,Q3,August 2017,-190375436,,190375436
Goods Returned (exports For Canada Only),September,2017,Q3,September 2017,-217492342,,217492342
Goods Returned (exports For Canada Only),October,2017,Q4,October 2017,-205574763,,205574763
Goods Returned (exports For Canada Only),November,2017,Q4,November 2017,-283734226,,283734226
Goods Returned (exports For Canada Only),December,2017,Q4,December 2017,-172860002,,172860002
Goods Returned (exports For Canada Only),January,2018,Q1,January 2018,-212399101,,212399101
Goods Returned (exports For Canada Only),February,2018,Q1,February 2018,-205486331,,205486331
Goods Returned (exports For Canada Only),March,2018,Q1,March 2018,-201409997,,201409997
Goods Returned (exports For Canada Only),April,2018,Q2,April 2018,-181108119,,181108119
Goods Returned (exports For Canada Only),May,2018,Q2,May 2018,-204636472,,204636472
Goods Returned (exports For Canada Only),June,2018,Q2,June 2018,-188536281,,188536281
Goods Returned (exports For Canada Only),July,2018,Q3,July 2018,-309871618,,309871618
Goods Returned (exports For Canada Only),August,2018,Q3,August 2018,-287625250,,287625250
Goods Returned (exports For Canada Only),September,2018,Q3,September 2018,-208026342,,208026342
Goods Returned (exports For Canada Only),October,2018,Q4,October 2018,-237623515,,237623515
Goods Returned (exports For Canada Only),November,2018,Q4,November 2018,-226709886,,226709886
Goods Returned (exports For Canada Only),December,2018,Q4,December 2018,-259276205,,259276205
Goods Returned (exports For Canada Only),January,2019,Q1,January 2019,-265017881,,265017881
Goods Returned (exports For Canada Only),February,2019,Q1,February 2019,-197604466,,197604466
Goods Returned (exports For Canada Only),March,2019,Q1,March 2019,-238157889,,238157889
Goods Returned (exports For Canada Only),April,2019,Q2,April 2019,-265944829,,265944829
Goods Returned (exports For Canada Only),May,2019,Q2,May 2019,-275932816,,275932816
Goods Returned (exports For Canada Only),June,2019,Q2,June 2019,-260096521,,260096521
Goods Returned (exports For Canada Only),July,2019,Q3,July 2019,-398017086,,398017086
Goods Returned (exports For Canada Only),August,2019,Q3,August 2019,-246680190,,246680190
Goods Returned (exports For Canada Only),September,2019,Q3,September 2019,-290416624,,290416624
Goods Returned (exports For Canada Only),October,2019,Q4,October 2019,-286298112,,286298112
Goods Returned (exports For Canada Only),November,2019,Q4,November 2019,-359814034,,359814034
Goods Returned (exports For Canada Only),December,2019,Q4,December 2019,-317351933,,317351933
Other Special Classification Provisions,January,2002,Q1,January 2002,-49655192,26868842,76524034
Other Special Classification Provisions,February,2002,Q1,February 2002,-63413577,20338017,83751594
Other Special Classification Provisions,March,2002,Q1,March 2002,-55552718,24254154,79806872
Other Special Classification Provisions,April,2002,Q2,April 2002,-61844140,25314804,87158944
Other Special Classification Provisions,May,2002,Q2,May 2002,-67127497,29047462,96174959
Other Special Classification Provisions,June,2002,Q2,June 2002,-78199635,21655352,99854987
Other Special Classification Provisions,July,2002,Q3,July 2002,-88519494,25198848,113718342
Other Special Classification Provisions,August,2002,Q3,August 2002,-79715729,25053256,104768985
Other Special Classification Provisions,September,2002,Q3,September 2002,-86410945,21110277,107521222
Other Special Classification Provisions,October,2002,Q4,October 2002,-84420338,23548528,107968866
Other Special Classification Provisions,November,2002,Q4,November 2002,-89848712,24887700,114736412
Other Special Classification Provisions,December,2002,Q4,December 2002,-83825349,33880340,117705689
Other Special Classification Provisions,January,2003,Q1,January 2003,-94530554,29943346,124473900
Other Special Classification Provisions,February,2003,Q1,February 2003,-86114371,20794082,106908453
Other Special Classification Provisions,March,2003,Q1,March 2003,-70631730,26520196,97151926
Other Special Classification Provisions,April,2003,Q2,April 2003,-98706762,26474304,125181066
Other Special Classification Provisions,May,2003,Q2,May 2003,-89686497,29390266,119076763
Other Special Classification Provisions,June,2003,Q2,June 2003,-80225979,38386528,118612507
Other Special Classification Provisions,July,2003,Q3,July 2003,-105118592,23861578,128980170
Other Special Classification Provisions,August,2003,Q3,August 2003,-96661383,27457970,124119353
Other Special Classification Provisions,September,2003,Q3,September 2003,-101546149,26143249,127689398
Other Special Classification Provisions,October,2003,Q4,October 2003,-110430771,32337346,142768117
Other Special Classification Provisions,November,2003,Q4,November 2003,-114982829,42492267,157475096
Other Special Classification Provisions,December,2003,Q4,December 2003,-106443000,39758335,146201335
Other Special Classification Provisions,January,2004,Q1,January 2004,-109502629,36404986,145907615
Other Special Classification Provisions,February,2004,Q1,February 2004,-107124702,30877502,138002204
Other Special Classification Provisions,March,2004,Q1,March 2004,-85869891,39473555,125343446
Other Special Classification Provisions,April,2004,Q2,April 2004,-110387381,43076174,153463555
Other Special Classification Provisions,May,2004,Q2,May 2004,-126836604,35790373,162626977
Other Special Classification Provisions,June,2004,Q2,June 2004,-135155390,31124028,166279418
Other Special Classification Provisions,July,2004,Q3,July 2004,-142986443,35464641,178451084
Other Special Classification Provisions,August,2004,Q3,August 2004,-147118771,28526252,175645023
Other Special Classification Provisions,September,2004,Q3,September 2004,-143952546,34243722,178196268
Other Special Classification Provisions,October,2004,Q4,October 2004,-142850974,33046323,175897297
Other Special Classification Provisions,November,2004,Q4,November 2004,-155190976,39388522,194579498
Other Special Classification Provisions,December,2004,Q4,December 2004,-159188799,34925201,194114000
Other Special Classification Provisions,January,2005,Q1,January 2005,-146511542,42519539,189031081
Other Special Classification Provisions,February,2005,Q1,February 2005,-146614497,30352898,176967395
Other Special Classification Provisions,March,2005,Q1,March 2005,-135339492,37539806,172879298
Other Special Classification Provisions,April,2005,Q2,April 2005,-129346138,41575625,170921763
Other Special Classification Provisions,May,2005,Q2,May 2005,-157326288,34630414,191956702
Other Special Classification Provisions,June,2005,Q2,June 2005,-154505896,45798862,200304758
Other Special Classification Provisions,July,2005,Q3,July 2005,-186592401,28710002,215302403
Other Special Classification Provisions,August,2005,Q3,August 2005,-165687721,40366900,206054621
Other Special Classification Provisions,September,2005,Q3,September 2005,-157722180,53920760,211642940
Other Special Classification Provisions,October,2005,Q4,October 2005,-183799976,39695675,223495651
Other Special Classification Provisions,November,2005,Q4,November 2005,-202275729,41584205,243859934
Other Special Classification Provisions,December,2005,Q4,December 2005,-178697319,58788534,237485853
Other Special Classification Provisions,January,2006,Q1,January 2006,-173813946,48017291,221831237
Other Special Classification Provisions,February,2006,Q1,February 2006,-176352503,45185827,221538330
Other Special Classification Provisions,March,2006,Q1,March 2006,-139320499,50504663,189825162
Other Special Classification Provisions,April,2006,Q2,April 2006,-172761045,54166304,226927349
Other Special Classification Provisions,May,2006,Q2,May 2006,-180214419,47075169,227289588
Other Special Classification Provisions,June,2006,Q2,June 2006,-189070458,45401052,234471510
Other Special Classification Provisions,July,2006,Q3,July 2006,-193611871,57041387,250653258
Other Special Classification Provisions,August,2006,Q3,August 2006,-198563900,45876905,244440805
Other Special Classification Provisions,September,2006,Q3,September 2006,-201353944,48585939,249939883
Other Special Classification Provisions,October,2006,Q4,October 2006,-219464652,45082049,264546701
Other Special Classification Provisions,November,2006,Q4,November 2006,-226199328,53852467,280051795
Other Special Classification Provisions,December,2006,Q4,December 2006,-212784376,59220224,272004600
Other Special Classification Provisions,January,2007,Q1,January 2007,-188848080,51558338,240406418
Other Special Classification Provisions,February,2007,Q1,February 2007,-249018249,43737017,292755266
Other Special Classification Provisions,March,2007,Q1,March 2007,-213954720,68470275,282424995
Other Special Classification Provisions,April,2007,Q2,April 2007,-210464843,65397678,275862521
Other Special Classification Provisions,May,2007,Q2,May 2007,-252490919,61499177,313990096
Other Special Classification Provisions,June,2007,Q2,June 2007,-236185961,78255150,314441111
Other Special Classification Provisions,July,2007,Q3,July 2007,-282533009,57868034,340401043
Other Special Classification Provisions,August,2007,Q3,August 2007,-258660652,55858966,314519618
Other Special Classification Provisions,September,2007,Q3,September 2007,-249655130,68465928,318121058
Other Special Classification Provisions,October,2007,Q4,October 2007,-295836760,65204856,361041616
Other Special Classification Provisions,November,2007,Q4,November 2007,-299663578,68196889,367860467
Other Special Classification Provisions,December,2007,Q4,December 2007,-280409526,73312755,353722281
Other Special Classification Provisions,January,2008,Q1,January 2008,-230578082,92373228,322951310
Other Special Classification Provisions,February,2008,Q1,February 2008,-235336781,64940581,300277362
Other Special Classification Provisions,March,2008,Q1,March 2008,-218561386,81603423,300164809
Other Special Classification Provisions,April,2008,Q2,April 2008,-248473038,82743843,331216881
Other Special Classification Provisions,May,2008,Q2,May 2008,-265637079,90016520,355653599
Other Special Classification Provisions,June,2008,Q2,June 2008,-271924067,82260878,354184945
Other Special Classification Provisions,July,2008,Q3,July 2008,-282998179,76927442,359925621
Other Special Classification Provisions,August,2008,Q3,August 2008,-289394570,83711310,373105880
Other Special Classification Provisions,September,2008,Q3,September 2008,-325876353,61837463,387713816
Other Special Classification Provisions,October,2008,Q4,October 2008,-338108561,74318248,412426809
Other Special Classification Provisions,November,2008,Q4,November 2008,-324693995,64419117,389113112
Other Special Classification Provisions,December,2008,Q4,December 2008,-261409548,91788020,353197568
Other Special Classification Provisions,January,2009,Q1,January 2009,-219634548,58519549,278154097
Other Special Classification Provisions,February,2009,Q1,February 2009,-219031825,53532370,272564195
Other Special Classification Provisions,March,2009,Q1,March 2009,-187866494,69944354,257810848
Other Special Classification Provisions,April,2009,Q2,April 2009,-234626187,83912836,318539023
Other Special Classification Provisions,May,2009,Q2,May 2009,-240637293,53741827,294379120
Other Special Classification Provisions,June,2009,Q2,June 2009,-215384189,69157493,284541682
Other Special Classification Provisions,July,2009,Q3,July 2009,-214966958,62702124,277669082
Other Special Classification Provisions,August,2009,Q3,August 2009,-235282181,49903085,285185266
Other Special Classification Provisions,September,2009,Q3,September 2009,-228094664,54496691,282591355
Other Special Classification Provisions,October,2009,Q4,October 2009,-245422812,51959683,297382495
Other Special Classification Provisions,November,2009,Q4,November 2009,-267016995,63124087,330141082
Other Special Classification Provisions,December,2009,Q4,December 2009,-238856274,75394634,314250908
Other Special Classification Provisions,January,2010,Q1,January 2010,-131766301,106479374,238245675
Other Special Classification Provisions,February,2010,Q1,February 2010,-104363672,115201854,219565526
Other Special Classification Provisions,March,2010,Q1,March 2010,-128813274,136761212,265574486
Other Special Classification Provisions,April,2010,Q2,April 2010,-151816115,120077063,271893178
Other Special Classification Provisions,May,2010,Q2,May 2010,-160989004,113287048,274276052
Other Special Classification Provisions,June,2010,Q2,June 2010,-218481774,119524785,338006559
Other Special Classification Provisions,July,2010,Q3,July 2010,-194101983,120150352,314252335
Other Special Classification Provisions,August,2010,Q3,August 2010,-230511388,112644420,343155808
Other Special Classification Provisions,September,2010,Q3,September 2010,-191937964,133719035,325656999
Other Special Classification Provisions,October,2010,Q4,October 2010,-169621386,130756861,300378247
Other Special Classification Provisions,November,2010,Q4,November 2010,-238908212,146517369,385425581
Other Special Classification Provisions,December,2010,Q4,December 2010,-163076040,147779262,310855302
Other Special Classification Provisions,January,2011,Q1,January 2011,-141040731,129942622,270983353
Other Special Classification Provisions,February,2011,Q1,February 2011,-142084616,90456547,232541163
Other Special Classification Provisions,March,2011,Q1,March 2011,-250350232,96365190,346715422
Other Special Classification Provisions,April,2011,Q2,April 2011,-231953636,73296812,305250448
Other Special Classification Provisions,May,2011,Q2,May 2011,-223174819,70689881,293864700
Other Special Classification Provisions,June,2011,Q2,June 2011,-290023438,87036498,377059936
Other Special Classification Provisions,July,2011,Q3,July 2011,-217771439,85293117,303064556
Other Special Classification Provisions,August,2011,Q3,August 2011,-285408406,73100520,358508926
Other Special Classification Provisions,September,2011,Q3,September 2011,-217409325,88059166,305468491
Other Special Classification Provisions,October,2011,Q4,October 2011,-230114073,91149846,321263919
Other Special Classification Provisions,November,2011,Q4,November 2011,-336254002,91645135,427899137
Other Special Classification Provisions,December,2011,Q4,December 2011,-264053112,91180678,355233790
Other Special Classification Provisions,January,2012,Q1,January 2012,-152761088,61309555,214070643
Other Special Classification Provisions,February,2012,Q1,February 2012,-147706877,73122997,220829874
Other Special Classification Provisions,March,2012,Q1,March 2012,-178304977,77163367,255468344
Other Special Classification Provisions,April,2012,Q2,April 2012,-164364195,64728608,229092803
Other Special Classification Provisions,May,2012,Q2,May 2012,-204943617,70578210,275521827
Other Special Classification Provisions,June,2012,Q2,June 2012,-170649587,67563300,238212887
Other Special Classification Provisions,July,2012,Q3,July 2012,-160246672,62705835,222952507
Other Special Classification Provisions,August,2012,Q3,August 2012,-183706063,65466728,249172791
Other Special Classification Provisions,September,2012,Q3,September 2012,-123735981,66874192,190610173
Other Special Classification Provisions,October,2012,Q4,October 2012,-141994501,81070305,223064806
Other Special Classification Provisions,November,2012,Q4,November 2012,-163310005,78259493,241569498
Other Special Classification Provisions,December,2012,Q4,December 2012,-119257519,78338085,197595604
Other Special Classification Provisions,January,2013,Q1,January 2013,-154033721,72308438,226342159
Other Special Classification Provisions,February,2013,Q1,February 2013,-96897278,94150651,191047929
Other Special Classification Provisions,March,2013,Q1,March 2013,-117808175,76424784,194232959
Other Special Classification Provisions,April,2013,Q2,April 2013,-154051150,66445121,220496271
Other Special Classification Provisions,May,2013,Q2,May 2013,-174943261,67764083,242707344
Other Special Classification Provisions,June,2013,Q2,June 2013,-150346276,64773479,215119755
Other Special Classification Provisions,July,2013,Q3,July 2013,-163898103,73745414,237643517
Other Special Classification Provisions,August,2013,Q3,August 2013,-175854488,74305121,250159609
Other Special Classification Provisions,September,2013,Q3,September 2013,-164491984,72258866,236750850
Other Special Classification Provisions,October,2013,Q4,October 2013,-150896807,103577144,254473951
Other Special Classification Provisions,November,2013,Q4,November 2013,-147809934,99129473,246939407
Other Special Classification Provisions,December,2013,Q4,December 2013,-157068004,100513009,257581013
Other Special Classification Provisions,January,2014,Q1,January 2014,-207792778,81176101,288968879
Other Special Classification Provisions,February,2014,Q1,February 2014,-162623982,79566041,242190023
Other Special Classification Provisions,March,2014,Q1,March 2014,-172917522,88763929,261681451
Other Special Classification Provisions,April,2014,Q2,April 2014,-205411014,75100043,280511057
Other Special Classification Provisions,May,2014,Q2,May 2014,-211403149,76897785,288300934
Other Special Classification Provisions,June,2014,Q2,June 2014,-203455064,82428744,285883808
Other Special Classification Provisions,July,2014,Q3,July 2014,-226625077,74868174,301493251
Other Special Classification Provisions,August,2014,Q3,August 2014,-213674653,77445507,291120160
Other Special Classification Provisions,September,2014,Q3,September 2014,-242154074,70839141,312993215
Other Special Classification Provisions,October,2014,Q4,October 2014,-224169071,101502149,325671220
Other Special Classification Provisions,November,2014,Q4,November 2014,-181534080,97550849,279084929
Other Special Classification Provisions,December,2014,Q4,December 2014,-197990787,90869195,288859982
Other Special Classification Provisions,January,2015,Q1,January 2015,-195648644,78433934,274082578
Other Special Classification Provisions,February,2015,Q1,February 2015,-160519538,78247064,238766602
Other Special Classification Provisions,March,2015,Q1,March 2015,-213909313,84818939,298728252
Other Special Classification Provisions,April,2015,Q2,April 2015,-211477359,74454412,285931771
Other Special Classification Provisions,May,2015,Q2,May 2015,-227012720,73067837,300080557
Other Special Classification Provisions,June,2015,Q2,June 2015,-220096460,73700653,293797113
Other Special Classification Provisions,July,2015,Q3,July 2015,-244694456,72995033,317689489
Other Special Classification Provisions,August,2015,Q3,August 2015,-220678059,84080086,304758145
Other Special Classification Provisions,September,2015,Q3,September 2015,-219764735,78984290,298749025
Other Special Classification Provisions,October,2015,Q4,October 2015,-189716464,91351817,281068281
Other Special Classification Provisions,November,2015,Q4,November 2015,-201025268,90665758,291691026
Other Special Classification Provisions,December,2015,Q4,December 2015,-214167979,81517072,295685051
Other Special Classification Provisions,January,2016,Q1,January 2016,-203808084,77438527,281246611
Other Special Classification Provisions,February,2016,Q1,February 2016,-194378525,79891711,274270236
Other Special Classification Provisions,March,2016,Q1,March 2016,-191239483,78108285,269347768
Other Special Classification Provisions,April,2016,Q2,April 2016,-191024630,67935712,258960342
Other Special Classification Provisions,May,2016,Q2,May 2016,-207680998,69467608,277148606
Other Special Classification Provisions,June,2016,Q2,June 2016,-199599864,74515405,274115269
Other Special Classification Provisions,July,2016,Q3,July 2016,-188915896,79522910,268438806
Other Special Classification Provisions,August,2016,Q3,August 2016,-215626109,86923089,302549198
Other Special Classification Provisions,September,2016,Q3,September 2016,-185624674,96554755,282179429
Other Special Classification Provisions,October,2016,Q4,October 2016,-169003876,111098842,280102718
Other Special Classification Provisions,November,2016,Q4,November 2016,-185768367,106893690,292662057
Other Special Classification Provisions,December,2016,Q4,December 2016,-189671361,100558190,290229551
Other Special Classification Provisions,January,2017,Q1,January 2017,-207944281,108366415,316310696
Other Special Classification Provisions,February,2017,Q1,February 2017,-174365551,87743322,262108873
Other Special Classification Provisions,March,2017,Q1,March 2017,-191966225,90904134,282870359
Other Special Classification Provisions,April,2017,Q2,April 2017,-183077867,100886587,283964454
Other Special Classification Provisions,May,2017,Q2,May 2017,-212009871,95332916,307342787
Other Special Classification Provisions,June,2017,Q2,June 2017,-217377611,91608928,308986539
Other Special Classification Provisions,July,2017,Q3,July 2017,-213487472,91445972,304933444
Other Special Classification Provisions,August,2017,Q3,August 2017,-232986072,99292638,332278710
Other Special Classification Provisions,September,2017,Q3,September 2017,-212170258,94661445,306831703
Other Special Classification Provisions,October,2017,Q4,October 2017,-194883469,121627284,316510753
Other Special Classification Provisions,November,2017,Q4,November 2017,-212542847,108050308,320593155
Other Special Classification Provisions,December,2017,Q4,December 2017,-215638550,101780045,317418595
Other Special Classification Provisions,January,2018,Q1,January 2018,-232232213,90740725,322972938
Other Special Classification Provisions,February,2018,Q1,February 2018,-167896766,95622042,263518808
Other Special Classification Provisions,March,2018,Q1,March 2018,-167825915,122681663,290507578
Other Special Classification Provisions,April,2018,Q2,April 2018,-208249188,86394870,294644058
Other Special Classification Provisions,May,2018,Q2,May 2018,-213752766,118726224,332478990
Other Special Classification Provisions,June,2018,Q2,June 2018,-226076071,103667955,329744026
Other Special Classification Provisions,July,2018,Q3,July 2018,-222206520,109880673,332087193
Other Special Classification Provisions,August,2018,Q3,August 2018,-266606390,92434066,359040456
Other Special Classification Provisions,September,2018,Q3,September 2018,-283996968,79180485,363177453
Other Special Classification Provisions,October,2018,Q4,October 2018,-297168393,102322987,399491380
Other Special Classification Provisions,November,2018,Q4,November 2018,-324196535,80143887,404340422
Other Special Classification Provisions,December,2018,Q4,December 2018,-328257477,85424704,413682181
Other Special Classification Provisions,January,2019,Q1,January 2019,-347154058,84454688,431608746
Other Special Classification Provisions,February,2019,Q1,February 2019,-260661836,91375100,352036936
Other Special Classification Provisions,March,2019,Q1,March 2019,-248341943,107073707,355415650
Other Special Classification Provisions,April,2019,Q2,April 2019,-329270637,97070498,426341135
Other Special Classification Provisions,May,2019,Q2,May 2019,-324385255,98647985,423033240
Other Special Classification Provisions,June,2019,Q2,June 2019,-274141309,91624124,365765433
Other Special Classification Provisions,July,2019,Q3,July 2019,-300528575,88169980,388698555
Other Special Classification Provisions,August,2019,Q3,August 2019,-300527222,99321721,399848943
Other Special Classification Provisions,September,2019,Q3,September 2019,-298769221,96969149,395738370
Other Special Classification Provisions,October,2019,Q4,October 2019,-292007805,101739060,393746865
Other Special Classification Provisions,November,2019,Q4,November 2019,-318015210,95312697,413327907
Other Special Classification Provisions,December,2019,Q4,December 2019,-336887033,118527840,455414873
